abdome	barriga
abdômem	barriga
abdominocentese	procedimento realizado no abdômem (barriga) para retirar líquido ou pus
abdução	movimento que afasta os membros, como pernas e braços, do centro do corpo; serve para testar até onde os braços e pernas conseguem ir
ablação	o médico queima as células doentes para melhorar os sintomas da doença
abordagem multidisciplinar	participação de vários especialistas (médicos e outros profissionais de saúde) no diagnóstico e escolha do tratamento de uma doença
abscesso	uma bolsa de pus que se forma nos tecidos, órgãos ou espaços dentro do corpo
acatisia	tremor, agitação e dificuldade para ficar sentado ou parado
acetilcolina	mensageiro químico (transmissor) envolvido em muitas funções do cérebro, como a memória e o controle dos movimentos
acidente vascular cerebral	derrame ou AVC
acidente vascular encefálico	o mesmo que AVC; derrame
ácido desoxirribonucleico	conjunto de moléculas que carrega a informação genética de todos os seres vivos (características da espécie e do indivíduo); o mesmo que DNA
ácido gama aminobutírico	mensageiro químico que regula a agitação do cérebro e do corpo, o que leva a uma sensação de calma; o mesmo que GABA
ácido úrico	composto produzido pelo fígado, mas que pode ter as quantidades aumentadas pela alimentação; quantidades muito altas de ácido úrico no organismo podem causar problemas de saúde como gota, pedras nos rins, pressão alta, entre outros
acidose	condição anormal que causa um quantidade grande de ácido no sangue
acinesia	paralisia, falta de movimento, incapacidade de se mover bem
acometer	atingir, afetar
acometer	pessoa que sofre com os sintomas e/ou consequências de uma doença
acompanhamento clínico	acompanhamento do paciente pelo profissional de saúde
acuidade	capacidade que a pessoa tem de perceber estímulos dos cinco sentidos (audição, olfato, paladar, tato, visão)
acuidade mental	capacidade que a pessoa tem de entender e usar as informações obtidas através dos sentidos (audição, olfato, paladar, tato, visão)
acuidade olfativa	capacidade do nariz para identificar cheiros; o mesmo que acuidade olfatória
acuidade olfatória	capacidade do nariz para identificar cheiros; o mesmo que acuidade olfativa
acuidade visual	capacidade do olho para identificar o contorno e a forma de objetos e pessoas
acupuntura	terapia de origem chinesa; o profissional aplica agulhas em pontos específicos do corpo para tratar doenças e promover saúde
adenite	íngua, caroço causado por inflamação
adenomegalia	aumento de uma glândula (*Ver glândula no glossário)
adenosina	remédio utilizado para tratar problemas no coração, como batimentos cardíacos fora do normal
adesão a o tratamento	quando o paciente concorda com o tratamento e segue as recomendações do profissional de saúde 
adh	substância presente no corpo humano que evita que o corpo perca muita água
administração de medicamento	uso de medicamentos (remédios) de acordo com a recomendação do médico
administrar medicamento	dar medicamentos (remédios) ao paciente de acordo com as recomendações do médico
adrenalina	substância que ativa diferentes sistemas do corpo, mantendo o corpo alerta
adrenoreceptores	*sem definição
adstringente	o que causa contração ou sensação de amarramento, como sabor de fruta verde.
adução	movimento que aproxima os membros, como pernas e braços, do centro do corpo (tronco)
afagia	dificuldade para engolir
afasia	perda da capacidade de expressar ou compreender a linguagem falada ou escrita
afebril	sem febre
afonia	sem voz
afônico	sem voz
agente colinérgico	substância que imita a ação da acetilcolina (*Ver acetilcolina no glossário)
agente neuroprotetor	substâncias/remédios usados para tentar proteger os neurônios
agente patogênico	organismos como bactérias, vírus, fungos etc. que podem causar doenças; o mesmo que patógeno
ageusia	perda da capacidade ou difficuldade para sentir gostos
agnosia	perda da capacidade ou dificuldade de identificar objetos pela audição (ouvir), pelo olfato (cheirar), pelo paladar (provar/gosto), pelo tato (tocar) e/ou pela visão (ver)
agnosia auditivo	perda da capacidade ou dificuldade de identificar objetos por meio do som, como um telefone tocando
agnosia gustativo	perda da capacidade ou dificuldade para sentir ou identificar o gosto de alimentos que a pessoa antes conhecia
agnosia olfativa	perda da capacidade ou dificuldade para sentir ou identififcar cheiros que a pessoa antes conhecia, como o cheiro de café
agnosia tátil	perda da capacidade ou dificuldade para indentififcar objetos antes conhecidos pelo tato (toque)
agnosia visual	perda da capacidade ou dificuldade para reconhecer pessoas ou objetivos antes conhecidos pela visão (ver/olhos)
agonista de o dopamina	substância (remédio) que imita o efeito da dopamina. Ver dopamina no Glossário.
agrotóxico	produtos usados na agricultura para combater insetos, doenças ou plantas daninhas
ait	ataque isquêmico transitório: o sangue não chega até o cérebro por um curto espaço de tempo
alcalinidade	quantidade de substâncias presentes na água ou outros líquidos capazes de neutralizar ácidos
alcoolismo	doença caracterizada pelo consumo incontrolável de bebidas alcoólicas; a pessoa bebe muito, a toda hora, sem controle 
alelo	variação do gene; um único gene possui muitos alelos e são os alelos que determinam como as características vão aparecer na pessoa. Existe um gene para cor dos olhos, mas são os alelos que vão determinar se os olhos são azuis, verdes, castanhos etc.
alexia	perda da capacidade ou dificuldade para leitura e escrita
alfa sinucleina	proteína que mais se acumula no cérebro da pessoa com Doença de Parkinson, destruindo células importantes
alimento protéico	alimentos ricos em proteína, como carnes brancas, vermelhas e frutos do mar, leite, ovos etc.
alopecia	perda de cabelo
alta hospitalar	documento entregue ao paciente, feito  por um hospital, que declara que o paciente internado já pode retornar para a sua casa ou lugar de moradia
alterações bioquímica	mudanças de substâncias químicas do corpo
alucinações	quando uma pessoa vê, cheira, ouve, sente ou prova algo que não existe
alzheimer	doença no cérebro, sem cura, que vai piorando com o tempo e destrói a memória e outras funções importantes do cérebro da pessoa
amantadina	remédio usado para tratar músculos rígidos (duros) e movimentos lentos
amaurose	cegueira total
ambliopia	baixa visão em um ou nos dois olhos; olho preguiçoso
amígdala	parte do cérebro que comanda as nossas emoções básicas (felicidade, tristeza, medo, surpresa, raiva e nojo) e o nosso instinto de sobrevivência, além da nossas lembranças emocionais, como momentos bons e ruis que tivemos 
amimia	perda da capacidade de fazer gestos ou sinais para representar ideias e sentimentos
aminar	substâncias orgânicas importantes na formação da proteína; existem diferentes tipos de aminoácidos, alguns são produzidos pelo nosso corpo e outros podem ser consumidos pela alimentação; os aminoácidos são importantes para os nossos músculos, células etc.
amnésia	perda de memória por períodos mais longos de tempo
ams	Atrofia Multissistêmica (*Ver Atrofia Multissistêmica no glossário)
amusia	dificuldade para compreender sons musicais por lesão no cérebro
anabólico	relacionado ao anabolismo (*Ver anabolismo no glossário)
anabolismo	processo que constrói moléculas complexas a partir de moléculas simples, como na construção dos músculos do corpo
analgesia	técnica em que são utilizados remédios que aliviam a dor, mas sem que o paciente fique inconsciente (perda dos sentidos)
anamnese	entrevista realizada pelo profissional de saúde com o paciente em busca do diagnóstico de uma doença
anatomia	descrição dos elementos que constituem o corpo
anatomopatologia	especialidade médica que estuda o diagnóstico das doenças baseado nos aspectos dos tecidos dos órgãos e das células
ancilose	rigidez (endurecimento) em uma articulação
anemia	condição em que a quantidade de glóbulos vermelhos (*Ver glóbulos vermelhos no glossário) no sangue está muito baixa, podendo causar cansaço, palidez, falta de ar, tonturas ou batimento acelerado do coração 
anemia falciforme	doença que faz com que os glóbulos vermelhos (*Ver glóbulos vermelhos no glossário) fiquem deformados (no formato de uma foice) e quebrem
anestesia	técnica usada em cirurgias e outros procedimentos para que o paciente não sinta dor; dependendo do tipo de anestesia o paciente pode ficar acordado ou inconsciente (perda dos sentidos)
anestesia geral	técnica usada em cirurgias; o médico aplica medicamentos e o paciente perde os sentidos, as sensações e os reflexos, não sentindo dor
anestesia local	técnica em que o médico aplicada pequenas quantidades de anestésico (remédio que tira ou diminui a sensibilidade e a dor) apenas no local da lesão (machucado) ou da intervenção. Um dentista faz anestesia local para arrancar um dente.
anestesia peridural	tipo de anestesia que bloqueia a dor e as sensações de apenas uma região do corpo, geralmente da cintura para baixo. Neste tipo de anestesia a pessoa pode ficar acordada, como as mulheres que recebem anestesia peridural na hora do parto.
anestesia raquidiano	tipo de anestesia que bloqueia a dor e as sensações de apenas uma região do corpo, geralmente da cintura para baixo  Neste tipo de anestesia a pessoa pode ficar acordada, como as mulheres que recebem anestesia raquidiana na hora do parto.
anestésico	medicamento que reduz ou tira a sensibilidade, reduzindo ou eliminando a dor
anestesiologia	especialidade médica que estuda como aliviar ou tirar a dor de pacientes que precisam fazer cirurgias ou exames
anestesiologista	médico que administra medicamentos como anestésicos (que reduzem a sensibilidade e a dor) e que monitora (acompanha) as funções vitais (batimentos cardíacos, respiração etc.) do paciente durante uma cirurgia
anestesista	médico que administra medicamentos como anestésicos (que reduzem a sensibilidade e a dor) e que monitora (acompanha) as funções vitais (batimentos cardíacos, respiração etc.) do paciente durante uma cirurgia
aneurisma	dilatação (alargamento) anormal da parede de um vaso sanguíneo, que pode acabar se rompendo e provocando perda de sangue ou derrame
aneurisma cerebral	dilatação (alargamento) anormal num dos vasos sanguíneos que levam sangue até ao cérebro
aneurisma de o aorta	dilatação (alargamento) anormal de alguma parte da aorta, a maior artéria (vaso sanguíneo) do corpo
anfetamina	substância que estimula a atividade do sistema nervoso central (*Ver SNC no glossário). O "rebite" que o caminhoneiro toma para se manter acordado é um exemplo de anfetamina.
angina	dor no peito causada pelo entupimento das artérias (vasos sanguíneos) do coração 
anomalia	aquilo que não é normal
anomalia congênita	anormalidade ou defeito presente desde o nascimento
anorexia	distúrbio (problema) alimentar em que a pessoa tem uma visão distorcida do próprio corpo, peso abaixo do normal, medo de ganhar peso, vontade intensa de ser magra 
anormalidade	aquilo que não é normal
anosmia	perda da capacidade ou dificuldade de sentir cheiros
anosognosia	incapacidade de perceber que se está doente
anoxia	falta de oxigênio
anoxia cerebral	falta de oxigênio no cérebro
anquilose	rigidez (endurecimento) de uma articulação
ansiolítico	grupo de remédios usado para diminuir a ansiedade e a tensão
antiálgica	que protege contra a dor
antibacteriano	substância que destrói as bactérias ou evita que elas se desenvolvam
antibiótico	remédios usados para tratar infecções causadas por bactérias
anticoagulante	remédios que impedem a formação de coágulos (forma sólida do sangue)
anticolinérgico	grupo de remédios que ajuda a diminuir os tremores (tremedeira)
anticonvulsivante	grupo de remédios que trata e previne convulsões, crises epilépticas, dores nos nervos e problemas de saúde mental, como bipolaridade; o mesmo que anticonvulsivo
anticolvulsivo	grupo de remédios que trata e previne convulsões, crises epilépticas, dores nos nervos e problemas de saúde mental, como bipolaridade; o mesmo que anticonvulsivo
anticorpo	proteínas que trabalham como defensores do organismo contra bactérias, vírus e outros corpos estranhos; o nosso corpo produz anticorpos para se defender de doenças
antidepressivo	grupo de remédios usado para tratar depressão e outras doenças
antiemético	remédios que evitam o vômito
anti inflamatório	substância ou remédio que combate as inflamações
antimicrobiano	substância que mata ou impede que bactérias, fungos, vírus ou protozoários se desenvolvam
anti retroviral	remédios usados para o tratamento de infecções por um tipo de vírus chamado retrovírus, principalmente o HIV
antirretroviral	remédios usados para o tratamento de infecções por um tipo de vírus chamado retrovírus, principalmente o HIV
antioxidante	substâncias que reduzem o envelhecimento das células 
antiparkisonianos	grupo de remédios que trata sintomas como tremores
antipsicótico	grupo de remédios usado para tratar algumas doenças da mente; podem ajudar também no controle das emoções, como agressividade, impusividade, mudanças bruscas de humor
antisséptico	impede que os micróbios (virus, bactérias, protozoários e fungos) se multipliquem e se espalhem
anúria	diminuição ou falta de urina na bexiga
aorta	a maior e mais importante artéria (vaso sanguíneo) do corpo; responsável por receber sangue com oxigênio do coração e enviar esse sangue para o resto do corpo
aparelho digestivo	órgãos que trabalham juntos para transformar os alimentos que comemos em combustível para que o nosso corpo funcione; são eles:  boca, faringe, esôfago, estômago, intestino delgado, intestino grosso, reto, fígado e pâncreas
aparelho digestório	órgãos que trabalham juntos para transformar os alimentos que comemos em combustível para que o nosso corpo funcione; são eles:  boca, faringe, esôfago, estômago, intestino delgado, intestino grosso, reto, fígado e pâncreas
aparelho reprodutivo	órgãos que trabalham juntos pela reprodução (geração de filhos); na mulher são a vagina, os ovários, as trompas e o útero e no homem são os testículos, o pênis, o escroto e a prostata  
aparelho reprodutor	órgãos que trabalham juntos pela reprodução (geração de filhos); na mulher são a vagina, os ovários, as trompas e o útero e no homem são os testículos, o pênis, o escroto e a prostata  
aparelho urinário	órgãos que trabalham juntos para produzir, guardar e eliminar a urina; esses órgãos são dois rins, dois ureteres, uma bexiga e uma uretra
aparelho vestibular	estruturas localizadas na nossa orelha interna e que nos mantêm em equilíbrio, sem cair
apatia	falta de interesse, emoção ou preocupação
apneia	quando a respiração é interrompida porque a pessoa quer (tranca-se a respiração para nadar numa piscina) ou sem querer (muitas pessoas têm apnéia durante o sono, quando param de respirar sem querer e sem notar por alguns segundos de cada vez)
apneia de o sono	quando a respiração para e volta diversas vezes enquanto a pessoa está dorminando sem que ela queira ou perceba; o mesmo que apneia noturna
apneia noturna	quando a respiração para e volta diversas vezes enquanto a pessoa está dorminando sem que ela queira ou perceba; o mesmo que apneia noturna
apraxia	quando a pessoa não consegue fazer tarefas que ela conhece apesar do desejo e capacidade física para realizá-las
área de broca	região do cérebro responsável pela expressão da linguagem (comunicação falada e escrita)
área de wernicke	uma das áreas do cérebro ligada à fala
arreflexia	perda de reflexo nos tendões (*Ver tendões no glossário)
arritmia	palpitação; o coração bate num ritmo diferente do normal
arteterapia	terapia que usa a arte como parte do tratamento do paciente
artéria	vasos que transportam sangue cheio de oxigênio do coração para o resto do corpo
artérias coronària	vasos que transportam sangue para o miocárdio (músculo do coração)
artéria pulmonar	vaso que leva o sangue do coração para os pulmões; única artéria (vaso sanguíneo) do corpo que carrega sangue com pouco oxigênio
articulação	junta(s)
artralgia	dor na articulação (junta)
artrite reumatóide	doença sem cura que causa inflamações em muitas articulações (juntas), inclusive nas juntas das mãos e dos pés
asfixia	alguma obstrução no caminho do oxigênio (ar); dificuldade ou impossibilidade de respirar
asma	doença nos pulmões que faz com que os brônquios (tubos que ligam a garganta aos pulmões) se fechem por estarem inflamados, fazendo com que o paciente fique com chiado e aperto no peito, falta de ar e tosse seca
assintomático	sem sintomas
astereognosia	dificuldade de reconhecer objetos pelo tato (toque)
ataque isquêmico transitório	o sangue não chega até o cérebro por um curto espaço de tempo; o mesmo que AIT
ataxia	falta de equilíbrio, movimentos descoordenados
ateroma	placa de gordura
aterosclerose	placas de gordura e outras substâncias nos vasos sanguíneos, fazendo com os vasos fiquem duros
atetose	movimentos descontrolados; o corpo se contorce sem querer, principalmente braços e mãos
ativação muscular	uso dos músculos
atonia	falta ou perda de tônus muscular (*Ver tônus muscular no glossário)
atrofia	falta de desenvolvimento, diminuição do tamanho ou peso de corpo, órgão, tecido ou membro
atrofia de múltiplos sistemas	doença que causa danos a partes do cérebro que controlam os movimentos e muitos processos internos do corpo, como controle da bexiga, pressão arterial etc
atrofia multissistêmica	doença que causa danos a partes do cérebro que controlam os movimentos e muitos processos internos do corpo, como controle da bexiga, pressão arterial etc
atrofiar	que não conseguiu se desenvolver completamente, que perdeu tamanho ou volume
audição	um dos cinco sentidos; é a capacidade de ouvir e processar (compreender) sons
audiologia	estudo da audição (como ouvimos)
auditivo	relacionado à audição ou ao ouvido
auricular	relacionado ao ouvido
auscultação	escuta dos sons internos do corpo, normalmente usando um aparelho estetoscópio (*Ver estetoscópio no glossário); o mesmo que ausculta
ausculta	escuta dos sons internos do corpo, normalmente usando um aparelho estetoscópio (*Ver estetoscópio no glossário); o mesmo que auscultação
autismo	condição relacionada com o desenvolvimento do cérebreo em que a pessoa pode ter dificuldade de se relacionar com o mundo e com as pessoas ao seu redor 
autópsia	exame feito em cadáver para determinar a causa e o modo da morte e avaliar doenças 
avaliação clínica	avaliação que o profissional de saúde faz da condição do paciente pelos sinais e sintomas que ele observa 
avc	derrame  
avds	atividades do dia a dia
azia	sensação de queimação no estômago
azilect	remédio que trata os sintomas iniciais da Doença de Parkinson
baço	pequeno órgão localizado na parte de cima abdômen (barriga) que filtra e armazena o sangue
bactéria	organismos muito pequenos e simples que podem causar doenças, mas que também são muito importantes para os seres humanos e têm várias funções no nosso corpo, como proteger o intestino
bactérias intestinal	conjunto de organismos muito pequenos que vivem no nosso intestino. Quando estão em harmonia, ajudam a proteger nosso intestino e nas defesas do corpo, quando se desequilibram podem causar doenças.
balismo	movimentos em que parece que a pessoa está arremessando algo; movimentos amplos, fortes e sem parar
barreira hematoencefálica	filtro entre o sangue e o cérebro que não deixa passar certos tipos de substâncias
benigno	que não faz mal
betabloqueadores	grupo de remédios que tem várias funções, como proteger o coração após um infarto
bexiga	órgão que armazena urina antes de ser eliminada do corpo
bexiga hiperativa	problema com o funcionamento da bexiga que provoca a vontade de urinar toda hora
bile	líquido produzido pelo fígado que ajuda na digestão de gorduras do intestino
biomarcadores	informações coletadas pelo profissional de saúde que ajudam a identificar quais tratamentos funcionam melhor para cada tipo de doença e para cada paciente
biópsia	procedimento no qual se colhe uma amostra de tecidos ou células do nosso corpo para ser estudada em laboratório; exame muito usado para diagnostica câncer 
biotina	vitamina antioxidante, conhecida como vitamina B-7, presente em alimentos como fígado, cerais, grãos e aveia
bipolaridade	doença que causa mudanças de humor, em que a pessoa pode passar de uma tristeza profunda (depressão) a muita euforia (mania) de uma hora para outra
blefarite	inflamação da pálpebra (pele que cobre e protege os olhos)
blefaroespasmo	movimento descontrolado dos olhos (fechamento ou piscadas)
borramento visual	visão embaçada, borrada
bradicardia	os batimentos do coração ficam mais lentos do que o normal
bradicinesia	diminuição e lentidão dos movimentos
bradifrenia	pensamento lento, perda de concentração, dificuldade para formar conceitos
bromocriptina	tipo de remédio usado no tratamento da Doença de Parkinson e outras doenças
brônquios	tubos que ligam a garganta aos pulmões e por onde passa o ar
bruxismo	a pessoa aperta ou range os dentes enquanto dorme
bucolingual	relacionado à boca e à língua
bulbo	estrutura que liga e faz a comunicação entre o cérebro e a medula espinhal
bulbo raquidiano	estrutura que liga e faz a comunicação entre o cérebro e a medula espinhal
butirofenonas	remédios usados para tratar distúrbios psiquiátricos (condições que afeftam o humor, o raciocínio e o comportamento)
cabergolina	remédio que imita os efeitos da dopamina no cérebro
cãimbra de o escritor	contração sem querer dos músculos da mão
cãimbra de o escrivão	contração sem querer dos músculos da mão
cãimbra	o músculo se contrai sem que a pessoa queira, causando dor
calázio	inflamação na pálpebra (pele acima dos olhos)que causa um caroço
calcificação	acúmulo de cálcio nos tecidos do corpo, tornando eles rígidos (duros) e espessos (grossos), entre outros problemas
cálcio	mineral muito importante para o corpo responsável por manter e dar força aos ossos
cálculo	pequenas pedras que podem aparecer, por exemplo, nos rins
cálculo biliar	pedras na vesícula (pequena bolsa localizada abaixo do fígado)
cálculo renal	pedras nos rins
caloria	medida de energia usada para medir tanto o consumo dos alimentos quanto a atividade física
caloso	duro como um calo
caminhada nórdica	tipo de caminhada em que a pessoa segura um bastão em cada mão para se apoiar um pouco, usada como atividade física para pessoas com Parkinson.
cancerígeno	que pode causar câncer (podem ser alimentos, substâncias, gases etc.)
capilar	os menores vasos sanguíneos; o mesmo que vasos capilares e capilares sanguíneos
capilar sanguíneo	os menores vasos sanguíneos; o mesmo que capilares e vasos sanguíneos
carbidopa	remédio usado no tratamento da Doença de Parkinson
carcinoma	tipo de câncer mais comum, pode surgir em praticamente todos os tecidos do corpo
cardíaco	relacionado ou que pertence ao coração
cardiologia	especialidade médica que estuda e trata o coração e suas doenças
cardiologista	médico que estuda e trata as doenças do coração
cardiomegalia	aumento do tamanho do coração
cardiopatia	relacionado a doenças do coração
cardiopatia congênita	defeitos do coração presentes desde o nascimento
cardiovascular	relacionado ao coração e aos vasos sanguíneos 
cartilagem	tecido mais firme, mas não tão duro quanto o osso, importante para sustentar e proteger partes do corpo, facilitar os movimentos e diminuir o atrito e o impacto entre os ossos
catabólico	relacionado ao catabolismo (*Ver catabolismo no glossário)
catabolismo	processo em que moléculas complexas são transformadas em moléculas menores, fornecendo energia ao organismo
catarata	nesta doença o cristalino, que é uma lente natural do olho, perde a transparência; o cristalino é responsável pelo foco da visão em diferentes distâncias. A catarata pode causar cegueira.
catatonia	sintoma de doença mental ou no cérebro; a pessoa pode ficar sem se mover, falar ou interagir por horas, dias ou semanas
catar	tubo usado para injeção ou retirada de fluidos do corpo; pode ser colocado por cima ou por baixo da pele
cavidade	espaços dentro do corpo que contêm os órgãos internos; as cavidades ajudam a proteger, isolar e sustentar os órgãos internos
cavidade abdominal	dentro desse espaço estão alojados diversoss órgãos do aparelho digestivo (estômago, intestinos, fígado, vesícula, pâncreas), baço, rins e parte dos ureteres
cavidade craniano	espaço onde o cérebro fica alojado
cavidade pélvica	espaço onde ficam alojadas a bexiga, uretra, parte dos ureteres, útero e vagina (na mulher), parte do intestino grosso e o reto
cavidade pleural	espaço ao redor dos pulmões
cavidade torácica	espaço dentro do tórax (peito) onde se encontam o esôfago, a traqueia, os pulmões e o coração
cefaleia	dor de cabeça
célula	menores unidades vivas com formas e funções definidas; existem organismos unicelulares (uma única célula), como as bactérias, e pluricelulares (com muitas células), como o ser humano
células estaminal não embrionária	células presentes em muitos tecidos do organismo adulto
células nervoso	células do sistema nervoso central (rede de comunicação do nosso corpo formada pelo cérebro, medula espinhal e nervos) que transmitem informações para todo o corpo
células piramidal	um tipo de neurônio em forma de triângulo encontrado em partes do cérebro e responsável pelos movimentos voluntários (que desejamos fazer) do nosso corpo
células tronco	células que podem se transformar em muitos tipos de células, o que significa que podem reparar outras células que tenham sido danificadas por doenças, acidentes ou pelo envelhecimento natural
centro de massa	local em que o peso do corpo fica concentrado
cerebelo	parte do cérebro responsável pelo movimento, equilíbrio e postura; sem o cerebelo seria impossível caminhar, jogar futebol, dançar, cozinhar etc.
cérebro	é o órgão mais importante do corpo; ele controla tudo o que você faz, pensa, sente, aprende, lembra (memória) e como você se move e fala, além de controlar também coisas que você nem se dá conta, como os batimentos do seu coração e a digestão da comida que você ingere
cerúleo	estrutura do cérebro responsável pela resposta ao estresse e fundamental no funcionamento do sono
cicatriz	marca deixada por uma ferida curada. Se você sofrer um corte profundo da mão, depois que a ferida curar, é muito provável que você fique com uma cicatriz no local.
cifose	curvatura anormal da coluna; corcunda
cinestesia	capacidade de perceber a posição e o movimento de uma parte do corpo.
cintilografia	tipo de exame por imagem
cintilografia óssea	exame que investiga a causa de problemas ou dores nos ossos
cirurgia bilateral	cirurgia nos dois lados do corpo, por exemplo, nas duas mamas, nos dois lados do cérebro
cirurgia unilateral	cirurgia só de um lado do corpo, por exemplo, mama esquerda, lado direito do cérebro
cisto	parecido com uma pequena bolsa, que pode ser cheia de ar, líquido, pus ou outro fluido, e que podem se formar dentro de qualquer tecido do corpo
citologia	estudo das células
citologista	pessoa especializada em estudar as células
clínica especializar	local onde vários médicos e outros profissionais de saúde trabalham
clonazepam	remédio usado para tratar convulsões e epilepsia
coagulação	processo que garante que a pessoa não perca muito sangue; nesse processo, o sangue perde suas características líquidas e se transforma em uma massa quase sólida, o que chamamos de coágulo
coágulo	forma sólida do sangue; o sangue perde suas características líquidas e se transforma em uma espécie de massa de sangue
coágulo sanguíneo	forma sólida do sangue; o sangue perde suas características líquidas e se transforma em uma espécie de massa de sangue
cóclea	estrutura da orelha interna responsável pela audição (como ouvimos)
coeficiente de letalidade	representa o risco que as pessoas com uma doença têm de morrer por essa mesma doença
cognição	capacidade do ser humano de processar informações e aprender através da percepção, atenção, associação, memória, raciocínio, juízo, imaginação, pensamento e linguagem
cognitivo	relacionado à cognição  (*Ver cognição no glossário)
colesterol	tipo de gordura encontrada em nosso organismo importante para o seu funcionamento normal; quando o nível de colesterol está muito alto ele pode fazer mal à saúde
colículos inferior	região do sistema nervoso central (*Ver sistema nervoso central no glossário) que recebe informações visuais (dos olhos)
colículos superior	região do sistema nervoso central (*Ver sistema nervoso central no glossário) que recebe informações auditivas (dos ouvidos)
cólon	parte central do intestino grosso, o cólon tem a função de absorver a água dos alimentos ingeridos que serão eliminadas pelo corpo através das fezes
colostomia	cirurgia que produz uma abertura no cólon (*Ver cólon no glossário), formando um novo caminho e local para a saída das fezes
coluna vertebral	dá sustentação ao corpo humano e ajuda na nossa locomoção, permitindo que caminhemos sobre os dois pés, sem precisar usar as mãos; além disso, protege os nervos da medula espinhal (*Ver medula espinhal no glossário); o mesmo que espinha dorsal
coma	condição em que a pessoa está viva, mas não reage a sons ou atividades ao seu redor, não faz nenhum movimento por vontade própria e o cérebro parece não estar alerta como antes
coma induzido	é um coma (*Ver definição de coma no glossário) provocado por uma dose (quantidade) de remédios controlada pelo médico e que irá durar o tempo que o médico achar necessário para o tratamento
coma irreversível	condição em que a pessoa está viva, mas não reage a sons ou atividades ao seu redor, não faz nenhum movimento por vontade própria e o cérebro parece não estar alerta; neste caso, a pessoa não retorna desse estado de coma
comorbidade	quando a pessoa tem duas ou mais doenças, sendo que uma doença pode potencializar (piorar) a outra
comprimento de o passar	distância de dois passos
comprometimento cognitivo	perda da capacidade de memória, linguagem e pensamento
compulsão	vontade incontrolável de fazer algo mesmo que não seja recomendado, como comer e beber demais, jogatina etc.
concussão	lesão (machucado) no cérebro que costuma melhorar depois de 24 horas
condição basal	quantidade mínima de energia que corpo da pessoa em repouso precisa para se manter vivo
confusão mental	pensamento confuso
congelamento de o marcha	parada súbita (de repente) da execução do movimento da caminhada
congênito	que vem desde o nascimento
congestão nasal	nariz entupido
constipação	intestino preso, dificuldade de evacuar
constritivo	alguma coisa que aperta, que (se) contrai; o mesmo que constritor
constritor	alguma coisa que aperta, que (se) contrai; o mesmo que constritivo
contraindicação	a ser evitado, não recomendado
contrair	a ser evitado, não recomendado
contratura	acontece quando o músculo se contrai sem que a pessoa queira e de maneira incorreta e não volta ao seu estado normal de relaxamento
controlo motor	controle dos movimentos
convulsão	é como se acontecesse uma descarga elétrica mais forte que o normal no cérebro; existem muitas causas diferentes para a convulsão; durante a convulsão, a pessoa fica rígida (dura), pode cair no chão e começar a se debater
coordenação motor	capacidade do nosso corpo de realizar e controlar os movimentos
coprolalia	vontade incontrolável de falar palavras e de fazer comentários inadequados
corda vocal	tecido cheio de músculos localizado dentro da laringe; quando a pessoa expulsa o ar pelas cordas vocais elas vibram produzindo o som pelo qual nos comunicamos; hoje o termo mais usado é prega vocal
coreia	movimentos descontrolados e rápidos que parecem uma dança
coriza	secreção que sai do nariz; nariz escorrendo
córnea	tecido transparente, fino e resistente localizado na parte da frente do olho (parece o vidro de um relógio); a córnea permite a entrada da luz e nos ajuda a focar em objetos e pessoas
corpo caloso	estrutura que conecta os lados direito e esquerdo do cérebro; é importante na organização das informações que chegam aos dois lados do cérebro
corpo estriar	parte central do cérebro com neurônios importantes; é uma das partes mais afetadas por doenças neurológicas como Doença de Parkinson e Alzheimer
corpo de lewy	agrupamento anormal de proteínas dentro de células nervosas
córtex	parte do cérebro responsável pela nossa capacidade de pensar e de interpretar as informações enviadas pelos nossos cinco sentidos (audição, olfafto, paladar, tato, visão)
córtex cerebral	parte externa do cérebro também conhecida como "massa cinzenta" por causa de sua cor acinzentada; é responsável pela nossa capacidade de pensamento, movimento voluntário (que fazemos por querer), linguagem e como vemos e entendemos o mundo
córtex motor primário	parte do cérebro responsável pelos movimentos do corpo voluntários (que queremos fazer); ajuda a planejar e executar atividades em que a pessoa precisa ter mais coordenação motora, como na prática de esportes
córtex visual	parte do cérebro responsável por perceber e reconhecer pessoas e objetos; diretamente ligado ao nosso sentido da visão
cortisol	hormônio (substâncias que regulam o nosso corpo) produzido pelas glândulas suprarreinas (Ver *glândulas suprarrenais no glossário) e que o nosso corpo libera quando estamos estressados
catecolamina	*sem definição
craniano	relacionado ao crânio
crânio	caixa óssea que protege o cérebro de danos externos
creatina	substância que dá energia aos músculos
crise epilética	descarga elétrica entre os neurônios mais duradoura que o normal, podendo causar convulsão
crise epiléptica	descarga elétrica entre os neurônios mais duradoura que o normal, podendo causar convulsão
crise oculogírica	descontrole do movimento dos olhos
cristalino	lente natural do olho responsável pelo foco da visão em diferentes distâncias. O olho foca em objetos como se fosse uma câmera fotográfica.
cromossomos	estruturas que contêm os genes (que carregam as informações genéticas de um ser vivo); nos seres humanos, cada célula contém 23 pares de cromossomos, incluindo os dois cromossomos responsáveis pelas características sexuais (XX na mulher e XY no homem)
cuidado paliativo	cuidados médicos não vão  curar o paciente, mas melhorar sua qualidade de vida e diminuir o sofrimento causado por doença grave e sem cura
cuidador	pessoa responsável por cuidar do paciente; pode ser um profissional contratado, um familiar ou amigo
dbs	Do inglês "Deep Brain Estimulation"; o mesmo que Estimulação Cerebral Profunda (*Ver Estimulação Cerebral Profunda no glossário)
dançaterapia	terapia que utiliza a dança como forma de tratamento
declínio cognitivo	perda de memória e atenção, problemas na fala e desordem de pensamento
decúbito	posição da pessoa que está deitada
decúbito dorsal	deitado de barriga para cima
decúbito lateral	deitado do lado esquerdo com a coxa e o joelho direitos junto ao peito ou deitado do lado direito com a coxa e joelho esquerdos junto ao peito
decúbito ventral	deitado de barriga para baixo
deficiência intelectual	atraso no desenvolvimento que pode ser percebido por dificuldades de aprendizado, de se relacionar com outras pessoas e de realizar atividades simples
degeneração estriadonitral	doença degenerativa dos neurônios (perda de neurônios)
degeneração estriatonigral	doença degenerativa dos neurônios (perda de neurônios)
degeneração estrionígrica	doença degenerativa dos neurônios (perda de neurônios)
degeneração nigroestriatal	doença degenerativa dos neurônios (perda de neurônios)
degeneração	mudança(s) para um estado pior
deglutição	ação de engolir 
deglutir	engolir
delírio	ideia ou pensamento que não é real
delirium	ideia ou pensamento que não é real
demência	perda de capacidades do cérebro, como memória e pensamento
demência de corpos de lewy	doença que causa a perda, aos poucos, das capacidades do cérebro (memória, pensamento etc.)
demência senil	perda de capacidade do cérebro pela velhice
demenciar	com sintomas de demência (*definição de demência)
densidade óssea	quantidade de cálcio que um osso tem
densitometria óssea	exame que determina a densidade do osso (quantidade de cálcio que um osso tem), importante no diagnóstico da osteoporose (*Ver osteoporose no glossário)
depleção	perda ou diminuição de substância presente no organismo, como sangue, água, sódio etc.
depressão	doença que causa tristeza e desânimo constante, entre outros sintomas
dermatite atópica	inflamação na pele que causa manchas ou feridas vermelhas que coçam muito e, às vezes, descamam (perdem camadas da pele); aparecem mais no rosto de crianças pequenas e nas dobras dos joelhos e cotovelos de crianças maiores e adultos
dermatite seborreico	inflamação na pele que causa manchas vermelhas e descamação (perda de camadas da pele), principalmente no couro cabeludo e em partes da face
derrame pleural	conhecido como água no pulmão, é o acúmulo de líquidos dentro da pleura, que é a estrutura que fica ao redor do pulmão para proteção
desfibrilação	aplicação de corrente elétrica no paciente, através de um desfibrilador (equipamento eletrônico que serve para fazer o coração voltar a bater no ritmo certo)
desfibrilador	equipamento eletrônico que serve para fazer o coração voltar a bater no ritmo certo
desidratação	condição que ocorre quando o seu corpo usa ou perde mais água, sais minerais e líquidos produzidos pelos próprio corpo do que você ingeriu; se você estiver desidratado, o corpo pode ter dificuldade para funcionar normalmente
desidratar	pessoa que perdeu muita água, sais minerais e outros líquidos produzidos pelo organismo
desmopressina	remédio que reduz a quantidade de urina que o corpo produz
desnutrição	falta de nutrientes suficientes no corpo causada por má alimentação ou doença
desordem neurológica	doença que atinge o sistema nervoso central (rede de comunicação do nosso corpo formada pelo cérebro, medula espinhal e nervos)
desorientação	estado de confusão em relação ao tempo, espaço e/ou identidade
desorientação temporoespacial	confusão em relação ao tempo e ao espaço. A pessoa pode não saber onde está e que dia é hoje.
desorientação temporo espacial	confusão em relação ao tempo e ao espaço. A pessoa pode não saber onde está e que dia é hoje.
diabetes	doença que ocorre quando o nosso corpo não consegue usar a glicose (tipo de açúcar) como deveria, fazendo com que o nosso sangue fique com muito açúcar
diabetes mellitu	doença que ocorre quando o nosso corpo não consegue usar a glicose (tipo de açúcar) como deveria, fazendo com que o nosso sangue fique com muito açúcar
diafragmar	músculo que ajuda na respiração (separa os pulmões dos outros ógrãos da barriga)
diagnóstico	definição do tipo de doença
diagnóstico clínico	quando o profissional de saúde define qual doença a pessoa tem pelos sinais e sintomas que ela apresenta
diagnóstico diferencial	quando o profissional de saúde define o tipo de doença, eliminando a possibilidade de a pessoa ter outras doenças. A pessoa apresenta tosse, febre e perda de peso. Na maioria dos casos, o diagnóstico será de pneumonia, mas se, após exames, o médico não detectar pneumonia, ele terá de procurar outras doenças, como tuberculose, câncer de pulmão etc.
diagnóstico histopatológico	definição da doença através da análise dos tecidos e células
diagnóstico precoce	é uma forma de prevenção e busca identificar a doença quando ela ainda está no início
diálise	tratamento que usa uma máquina que funciona como um rim artificial; ela retira sangue do corpo, filtra esse sangue e bombeia sangue limpo de volta para o corpo
diástole	quando o coração bate, ele tem um período de contração e outro de relaxamento, a diástole é o período em que o coração está relaxado
diencéfalo	*sem definição
dieta cetogênica	dieta em que a pessoa come mais gordura boa (como de óleos, nozes, castanhas etc.), um pouco de proteínas (peixes, carnes) e muito pouco carboidrato (pães, massas etc.)
digestão	os nutrientes dos alimentos precisam chegar até as células para nutrir o nosso corpo, mas a maioria deles não chega diretamente, pois as células só conseguem absorver nutrientes simples; esse processo de “simplificação” recebe o nome de digestão
digestivo	relacionado à digestão ou ao sistema digestivo (*Ver digestão / sistema digestivo no glossário)
digestório	relacionado à digestão ou ao sistema digestivo (*Ver digestão / sistema digestivo no glossário)
diplopia	visão dupla; a pessoa vê duas imagens no mesmo objeto/pessoa
disartria	fraqueza nos músculos usados na fala, o que pode deixar a fala arrastada ou lenta
disautonomia	quando o sistema nervoso autônomo  (*definição de sistema nervoso autônomo) não funciona bem, afetando o coração, a bexiga, os intestinos, as glândulas de suor, as pupilas (olhos) e os vasos sanguíneos
discinesia	movimentos amplos que a pessoa faz sem querer, com balanceios do corpo, movendo o corpo de um lado para outro 
discrasia	condição anormal no sangue
disdiadococinesia	dificuldade de fazer movimentos rápidos em sequência
disfagia	dificuldade para engolir
disfasia	dificuldade de falar
disfemia	gagueira
disfluência	a fala fica quebrada, como na gagueira
disfonia	dificuldade para emitir sons, voz alterada ou fraca
disforia	estado de desconforto, tristeza ou mal-estar
disfunção	funcionamento anormal
disfunção erétil	ocorre quando um homem não consegue ter ou manter uma ereção firme o suficiente para a relação sexual
disfunção miccional	problemas relacionados com a bexiga e para urinar; quando a pessoa tem vontade de fazer xixi o tempo todo, sente dor ao urinar, entre outros problemas 
disfunção olfativa	dificuldade para sentir cheiros
disfunção sexual	dificuldade sentida por uma pessoa ou casal durante o sexo
disfunção visual	problemas de visão
disfunção autonômica	quando o sistema nervoso autônomo (*Ver sistema nervoso autônomo no glossário) não funciona bem, afetando o coração, a bexiga, os intestinos, as glândulas de suor, as pupilas (olhos) e os vasos sanguíneos
dislipidemia	aumento da taxa de gordura no sangue, colesterol alto
dismetria	dificuldade para fazer movimentos com o objetivo de atingir um alvo, pois a pessoa não consegue controlar bem o movimento
disosmia	quando a pessoa não consegue diferenciar ou sentir cheiros
dispareunia	dor durante o sexo
dispepsia	sensação de dor ou desconforto na parte superior do abdomêm (barriga), queimação
displasia	desenvolvimento anormal de um órgão ou tecido; indica que as células podem ter sido alteradas em sua forma, tamanho, organização e função (o que elas fazem no nosso corpo)
dispneia	respiração difícil ou dolorosa; dificuldade para respirar
disprosódia	alteração no ritmo da fala, como acontece na gagueira; o mesmo que disritmolalia
disritmolalia	alteração no ritmo da fala, como acontece na gagueira; o mesmo que disprosódia
dissecação	abertura e/ou separação de organismos mortos (plantas, animais etc.) para estudo
distal	afastado do tronco (do centro do corpo)
distensão muscular	rompimento de um músculo ou de tecido que liga o músculo ao osso
distonia	contração dos músculos sem que a pessoa queira
distônica	relacionado à distonia (*Ver distonia no glossário)
distrofifa	desenvolvimento anormal
distrofia muscular	doenças genéticas (que passam dos pais para os filhos) que causam fraqueza nos músculos e perda de massa muscular
distúrbio	funcionamento anormal de um órgão ou sistema do corpo
distúrbio comportamental de o sono rem	caracterizado por pesadelos em que a pessoa grita, chora, dá socos ou pontapés; pode ser um problema anterior ao desenvolvimento da doença de Parkinson
distúrbio não motor	problemas não relacionados ao movimento
distúrbio de movimento	doenças que causam problemas nos movimentos; dificuldade para se movimentar
distúrbio de o sono	dificuldade para dormir 
distúrbio autonômico	quando o sistema nervoso autônomo (*definição de sistema nervoso autônomo) não funciona bem, afetando o coração, a bexiga, os intestinos, as glândulas de suor, as pupilas (olhos) e os vasos sanguíneos
distúrbios cerebelar	doenças em que o cerebelo (parte do cérebro responsável pelo equilíbrio, movimentos etc.) não funciona bem
distúrbios neurocomportamental	problemas de comportamento da pessoa relacionados a problemas neurológicos (no cérebro)
distúrbio neuropsiquiátrico	problemas de comportamento da pessoa relacionados a problemas neurológicos (no cérebro)
distúrbio psiquiátrico	condições que afetam o humor, o raciocínio (pensamento) e o comportamento
distúrbio vestibular	tontura e desequilíbrio
distúrbios visual	dificuldades para enxergar bem
diurese	aumento da quantidade de urina que é eliminada pelo corpo
diurético	remédios utilizados para aumentar a quantidade de urina produzida e sua eliminação do corpo, reduzindo também a pressão se a pessoa tiver pressão alta
dna	conjunto de moléculas que carregam a informação genéticas de todos os seres vivos (características da espécie e do indivíduo)
doença autoimune	algumas vezes o nosso sistema imune (*Ver sistema imune no glossário) se confunde e ataca as células do nosso próprio corpo. A diabetes tipo 1, em que o sistema imune destrói as células do pâncreas que produzem insulina (hormônio que controla a quantidade de açúcar no sangue) é um exemplo de doença autoimune.
doença autossômica dominante	tipos de doenças que aparecem em todas as gerações de uma família e apenas um gene do pai ou da mãe é necessário para que a doença seja transmitida
doença autossômica recessivo	tipos de doenças que precisam de dois genes ou mais com defeito, do pai e da mãe, para que a doença seja transmitida para o filho(a)
doença crônica	doença sem cura e que exige que a pessoa use remédios sempre, sem poder interromper o uso.
doença crônico neurodegenerativa	doença que prejudica a saúde do cérebro
doença de alzheimer	doença progressiva que vai destruindo a memória e outras funções mentais da pessoa
doença de corpos de lewy	doença que causa a perda, aos poucos, das capacidades do cérebro (memória, pensamento etc.)
doença de parkinson	doença do sistema nervoso central, rede de comunicação do nosso corpo formada pelo cérebro, medula espinhal e nervos que controla tudo o que fazemos, inclusive os movimentos. A pessoa com Parkinson, com o tempo, vai perdendo a capacidade de controlar os movimentos do corpo. Os principais sintomas são tremores (mãos tremendo), dificuldade para manter o equilíbrio e a coordenação, dificuldade para levantar e caminhar e rigidez dos movimentos (movimentos limitados e difíceis).
doença congênita	doença que acompanha a pessoa desde o nascimento
doença neurodegenerativa e crônica	doença que prejudica a saúde do cérebro
doença bucal	doença na boca
doença degenerativo	tipo de doença em que a condição da pessoa vai piorando aos poucos
doença extrapiramidal	doença que ocorre em uma parte do cérebro que controla os movimentos
doença genética	doença que passa dos pais para os filhos causada por um problema no DNA (*Ver DNA no glossário)
doença hereditária	doença que passa dos pais para os filhos
dopamina	substância que atua como uma mensageira entre as partes do cérebro e o sistema nervoso, ajudando no controle e na coordenação dos movimentos, entre outras funções
dopaminérgico	relacionado à dopamina (*definição de dopamina)
dopler	exame  que mede a velocidade do fluxo de sangue dentro dos vasos
dor aguda	dor forte que surge de repente e que, normalmente, não dura por muito tempo
dor crônica	dor persistente que dura de semanas a anos
dor fulgurante	dor rápida e muito forte, como a dor de pontadas
dor lancinante	dor em golpes, aguda e forte
dor radicular	dor causada por lesão (mechucado) ou irritação em um ou mais nervos da coluna vertebral
dosagem	a quantidade de remédio necessária para que o paciente tenha uma boa resposta ao tratamento
dosagem prescrito	quantidade de remédio recomendada pelo médico
dp	DP = Doença de Parknson (*Ver Doença de Parkinson no glossário)
dpoc	Doença Pulmonar Obstrutiva Crônica: grupo de doenças nos pulmões que bloqueiam o fluxo de ar e tornam a respiração mais difícil
droga	remédio
droga sintética	substâncias produzidas através de químicos criados pelo homem ao invés de substâncias naturais
duloxetina	remédio que trata depressão e outros problemas psiquiátricos (mente e comportamento)
duodeno	é a parte inicial e mais curta do intestino delgado; sua principal função é receber os alimentos digeridos pelo estômago e continuar o processo de digestão
ecocardiograma	exame do coração que fornece imagens obtidas através do som produzido pelo coração
ecolalia	quando a pessoa fica repetindo o que acabou de falar ou o que a pessoa com quem está conversando acabou de falar
ecp	Estimulação Cerebral Profunda: cirurgia mais utilizada para combater sintomas como tremores (tremedeira)
eczema	inflamação na pele
edema	inchaço
edema periférico	inchaço nas extremidades (mãos, pés, tornozelos etc.)
edêntulo	sem dentes
efeito "wearing off "	quando o efeito do remédio dura menos do que deveria
efeito neuroprotetor	mecanismos e estratégias usados para proteger os neurônios contra danos causados por doenças
efeito colateral	efeito diferente do pretendido (esperado) de um remédio
efeito adverso	qualquer efeito não desejado de um remédio
ecg	eletrocardiograma; exame feito com um aparelho ligado a eletrodos (peças metálicas), que avalia o ritmo dos batimentos do coração em repouso
ecmo	máquina que substitui o coração e o pulmão em pacientes graves
egg	eletroencefalograma; exame utilizado para detectar doenças que grava a atividade elétrica do cérebro
eletrocardiograma	exame feito com um aparelho ligado a eletrodos (peças metálicas) que avalia o ritmo dos batimentos do coração em repouso; o mesmo que ECG
eletrodar	peça metálica formada por 4 contatos elétricos na ponta; o eletrodo é colocado na parte do cérebro escolhida
eletroencefalograma	exame utilizado para detectar doenças que grava a atividade elétrica do cérebro
eletromiografia	exame que grava da atividade elétrica de um músculo; o mesmo que EMG
embolia	boqueio de um vaso sanguíneo causado por um coágulo (forma sólida do sangue) 
embolia arterial	boqueio de um vaso sanguíneo causado por um coágulo (forma sólida do sangue) 
embolia cerebral	ocorre quando um coágulo de sangue (forma sólida do sangue) viaja até o cérebro, causando um AVC (derrame)
embolia pulmonar	doença em que artérias (vasos) do pulmão ficam bloqueadas por coágulos de sangue (formas sólidas do sangue)
êmese	vômito
emg	eletromiografia; exame que grava da atividade elétrica de um músculo
encefálico	relacionado ao encéfalo (*Ver encéfalo no glossário)
encefalite	inflamação do cérebro
encefalite letárgica	doença que causa  letargia (*Ver letargia no glossário), sono difícil de controlar e tremores (tremedeira)
encéfalo	centro do sistema nervoso, funciona como um computador que reúne e processa todas as informações, enviando mensagens para o resto do nosso corpo; é diferente do cérebro pois inclui outras partes do sistema nervoso; o cérebro faz parte do encéfalo
encefalopatia	termo usado para qualquer doença no cérebro que altera o funcionamento ou a estrutura do cérebro
encefalopatia de o pugilista	doença causada por trauma na cabeça
endemia	quando a doença está presente em uma área/região sempre, o tempo todo, durante anos e anos. A dengue é uma doença endêmica no Brasil, pois está presente aqui por muitos anos.
endocárdio	camada que cobre a parte interna do coração
endocrinologia	especialidade médica que cuida do funcionamento das glândulas e de suas doenças; as glândulas produzem e liberam hormônios (substâncias que regulam o nosso corpo)
endocrinologista	médico que cuida das doenças relacionadas às glándulas e aos hormônios (substâncias que regulam o nosso corpo) produzidos e liberados por elas
endógeno	que se forma no interior do nosso organismo
endoscopia	exame nos órgãos do sistema digestivo (sistema que transforma a comida que comemos em energia para o nosso corpo) para avaliar doenças como refluxo, gastrite e câncer
endoscópio	aparelho que faz imagens de dentro do nosso corpo
endovenoso	injeção aplicada dentro das veias; o mesmo que intravenoso
enfarte	ataque do coração; ocorre quando o fluxo de sangue deixa de chegar ao músculo do coração, fazendo com que esse músculo seja danificado ou morra
enfarto	ataque do coração; ocorre quando o fluxo de sangue deixa de chegar ao músculo do coração, fazendo com que esse músculo seja danificado ou morra
enfarto de o miocárdio	ataque do coração; ocorre quando o fluxo de sangue deixa de chegar ao músculo do coração, fazendo com que esse músculo seja danificado ou morra
enfermidade	doença
enfermo	doente
entacapona	tipo de remédio utilizado no tratamento da Doença de Parkinson
entubar	colocar tubo ou sonda no paciente
extubar	remover tubo ou sonda do paciente
enurese	perda de controle da bexiga, que pode ser desde gotas de xixi após espirrar, tossir ou rir até a total  falta de capacidade de controlar a urina
enxaqueca	dor de cabeça muito forte que pode causar enjoo e sensibilidade à luz
enzima	proteína muito importante para manter as células do corpo funcionando bem; pessoas com a Doença de Parkinson podem apresentar alterações nas enzimas do corpo
epidemia	quando uma doença tem um aumento muito grande de casos durante um tempo, mas depois o número de casos cai. Países passam por epidemias de gripe todos os anos, principalmente no inverno, pois o número de casos de gripo aumenta muito nesta época.
epidemiologia	estudo do que causa a doença e como ela se comporta em grupos de pessoas
epiderme	camada externa da pele
epilepsia	doença cerebral sem cura em que a pessoa tem ataques epiléticos, convulsões 
epinefrina	hormônio produzido pelo nosso corpo e remédio com efeitos em diferentes sistemas do corpo; quando remédio pode ser usado em situações de emergência como crises de alergia grave e em muitas outras situações 
episódio	um período importante durante uma doença, que deve ser levado em consideração pelo médico
equimose	mancha avermelhada ou escura na pele causada por um machucado
ereto	posição de pé
eritema	tipo de vermelhidão da pele
eritema multiforme	inflamação na pele que causa placas vermelhas e salientes em todo o corpo
eritema nodoso	inflamação da camada de gordura abaixo da pele que provoca caroços vermelhos ou roxos 
eritrócito	também chamadas de hemácias ou glóbulos vermelhos, são células do sangue importantes para levar oxigênio aos tecidos do corpo; também são responsáveis pela cor vermelha do sangue
eritromelalgia	doença rara em que pequenos vasos da pele se dilatam (expandem), provocando dor, sensação de pele quente e vermelhidão
escala de apgar	medida que avalia como está um bebê recém-nascido, feita 1 minuto após o nascimento e repetida depois de 5 minutos
escala de ashworth	escala mais utilizada para avaliar e medir a espasticidade (tônus muscular aumentado); varia de 0 a 4
escala de lawton	mede a capacidade dos idosos de realizarem atividades mais complexas que as atividades simples do dia a dia; o mesmo que índice de Lawton
esclerose	degeneração (mudança para um estado pior) dos tecidos do corpo, que pode ocorrer em vários órgãos e estruturas, como nervos, pulmões etc.
esclerose hipocampal	atrofia (diminuição do tamanho) em uma parte do cérebro chamada hipocampo (*Ver hipocampo no glossário)
esclerose de o hipocampo	atrofia (diminuição do tamanho) em uma parte do cérebro chamada hipocampo (*Ver hipocampo no glossário)
esclerose mesial	*sem definição
esclerose múltipla	doença que afeta o cérebro, os nervos que ligam os olhos ao cérebro e a medula espinhal; o sistema de defesa do nosso corpo confunde células saudáveis com células "intrusas" e as ataca danificando essas células
escoliose	a coluna fica curvada de um jeito anormal
escorar de apgar	mede como um bebê recém-nascido está 1 minuto após o nascimento e novamente depois de 5 minutos
escotoma	ponto cego; quando a pessoa perde a capacidade de visão em um ponto específico do campo de visão
esfignomanômetro	aparelho usado para para medir a pressão sangúinea (pressão que o sangue faz contra os vasos)
esfíncter	estrutura do corpo, normalmente um músculo, que abre ou fecha orifícios no nosso corpo
esofagite	inflamação do esôfago (*Ver esôfago no glossário) que pode provocar dor e dificuldade para engolir
esôfago	canal que leva o alimento até o estômago
espasmo	contração sem controle do músculo
espasmódico	que causa ou que tem espamos (*Ver espasmo no glossário)
espasticidade	estado anormal do músculo envolvenodo o aumento do tônus muscular e dos reflexos
esperança de vida a o nascer	cálculo que faz uma média de quantos anos uma pessoa vai viver. No brasil, uma pessoa nascida em 2020 vai viver, em média, 76,6 anos, esse número pode mudar dependendo da vida que a pessoa tiver
espinha dorsal	dá sustentação ao corpo humano e ajuda na nossa locomoção, permitindo que caminhemos sobre os dois pés, sem precisar usar as mãos; além disso, protege os nervos da medula espinhal (*Ver medula espinhal no glossário); o mesmo que espinha dorsal
esplenomegalia	aumento do baço (*Ver baço no glossário)
estabilidade dinâmica	equilíbrio ao se movimentar
estabilidade estática	equilíbrio ao ficar parado
estadiamento	avaliação da extensão do tumor no paciente
estereognosia	capacidade de perceber com as mãos a forma e o tamanho de um objeto
estereotaxia	cirurgia sem cortes grandes utilizada para localizar pequenos alvos no interior do corpo e executar neles alguma atividade, como injeção de uma substância etc.
estereotipia	ação repetitiva no movimento, postura ou fala; a pessoa fala a mesma coisa sem parar, não consegue parar de se movimentar etc.
esteroides	tipo de hormônio (substância) que controla várias funções do nosso corpo, como as características sexuais de uma pessoa, entre outras
estetoscópio	instrumento que ajuda o profissional de Saúde a escutar sons internos do nosso corpo
estimulação cerebral profunda	cirurgia mais utilizada para combater sintomas como tremores
estimulação colinérgica	estímulo de um tipo de neurônio chamado colinérgico (*Ver neurônios colinérgicos no glossário)
estimulação dopaminérgica	estímulo para que o cérebro libere mais dopamina (*Ver dopamina no glossário)
estimulação magnética transcraniana	*sem definição
estimulação magneto térmica	nova técnica sem cortes grandes usada para ativar pequenos grupos de células do cérebro
estimulação talâmica	estímulo dos neurônios da região do tálamo (*Ver tálamo no glossário)
estímulo dopaminérgico	estímulo para que o cérebro libere mais dopamina (*Ver dopamina no glossário)
estiramento	rompimento de um músculo ou do tecido que liga o músculo ao osso
estômago	órgão que parece uma bolsa; localizado do lado esquerdo no abdômem (barriga), é nele que os alimentos são digeridos 
estomatite aftoso	aftas na boca
estrabismo	desvio anormal do olho; vesguice
estresse	resposta do nosso corpo a uma situação difícil, de ameaça ou pressão
estresse oxidativo	quando a membrana celular (*definição de membrana celular) se rompe, liberando substâncias tóxicas no organismo
estressores primário	*sem definição
estressores secundário	*sem definição
estriar	parte central do cérebro com neurônios importantes; é uma das partes mais afetadas por doenças neurológicas como Doença de Parkinson e Alzheimer
estrogênio	hormônio (substância que regula o nosso corpo) responsável pelas características femininas e pela ovulação (processo em que a mulher libera um óvulo e pode engravidar) 
estudo randomizados	estudos nos quais os grupos estudados são divididos aleatoriamente (sem preferências)
estupor	a pessoa não responde e só consegue ser despertada se receber estímulos físicos vigorosos, como sacudidas fortes ou algo que a faça sentir dor
etiologia	estudo que busca as causas, por exemplo, de uma doença
etopropazina	tipo de remédio usado no tratamento da Doença de Parkinson e outras doenças
eupneia	respiração normal
eutanásia	quando um paciente recebe o direito de morrer para aliviar o sofrimento causado por uma doença que não tem cura
evento adverso	qualquer acontecimento relacionado à saúde do paciente e que não tem relação com o tratamento
evidência clínica	sinais e sintomas que confirmam doenças
exame ocular	teste realizado nos olhos para avaliar a visão do paciente
exame oftalmológico	exame que avalia os olhos, as pálpebras e os canais por onde saem as lágrimas para investigar doenças nos olhos, como o glaucoma ou a catarata (*Ver glaucoma e catarata no glossário), entre outras doenças nos olhos
exame audiológico	exames que medem se a pessoa escuta bem ou não
exame laboratorial	exames feitos em laboratório
exame histopatológico	exame dos tecidos do corpo para diagnóstico de câncer; este exame também serve para diagnosticar outras doenças, como tuberculose, micoses, infecções etc
excitotoxicidade	quando as células são super estimuladas e podem acabar sendo danificadas ou morrendo
exérese	remoção por cirurgia
exoma	exame que identifica doenças genéticas; conjunto de aproximadamente 180.000 éxons (*definição de éxons); fração do genoma (*definição de genoma)
éxons	regiões dos genes que codificam proteínas
espectativa de vida	cálculo que faz uma média de quantos anos uma pessoa vai viver. No brasil, uma pessoa nascida em 2020 vai viver, em média, 76,6 anos, esse número pode mudar dependendo da vida que a pessoa tiver.
eupnéica	respiração normal
expectorante	substância ou remédio que facilita a liberação de secreções, como catarro, nariz entupido etc.
expectorar	liberar secreções, como catarro, nariz entupido etc.
expiração	processo de soltar o ar
expirar	soltar o ar
exposição crônica	quando a pessoa é exposta a algo ou a uma substância por muito tempo. A pessoa trabalha em um ambiente onde se usam pesticidas e fica exposta a essa substância diariamente.
extremidade	mãos, pés e orelhas
fabulação	substituir a realidade por uma aventura imaginária
fácies de máscara	a face parece uma máscara porque fica sem expressão, o olhar fica parado, vago e fixo
fácies parkisoniana	sintoma da doença de Parkinson e de outras doenças; a face parece uma máscara porque fica sem expressão, o olhar fica parado, vago e fixo
fadiga	cansaço, exaustão
faringe	tem a função de fazer a passagem do ar que inalamos (respiramos) e dos alimentos que comemos até os outros órgãos
fármaco	remédio
farmacologia	ciência que estuda como os medicamentos ou substâncias interagem com o organismo
farmacológico	relacionado à farmacologia (*Ver farmacologia no glossário)
farmacoterapia	tratamento de pacientes com o uso de remédios
fáscia	faixa de tecido ao redor do músculo
fator ambiental	fatores que podem contribuir para uma doença e que estão presentes no ambiente onde a pessoa vive, como doenças causadas pela falta de esgoto nos bairros e casas
fator de risco	qualquer situação que aumente as chances de uma pessoa ficar doente ou de piorar da doença
fator genético	fatores que contribuem para o surgimento de uma doença e que foram passados de pais para filhos
fator predisponente	fatores que criam as condições para o surgimento de uma doença. Os fatores predisponentes, ou seja, que contribuem para a pessoa ter pressão alta são estar acima do peso, estresse, fumar e não fazer exercícios
fda	do inglês Food and Drug Administration: órgão do governo dos Estados Unidos que controla a liberação de vários tipos de alimentos e substâncias (tanto para humanos quanto para animais), incluindo remédios
febril	com febre
fêmur	osso longo da coxa; maior osso do corpo humano
fenótipo	características que podem ser observadas em uma pessoa ou animal e que são determinadas pela genética e pelo meio ambiente, como cor do cabelo, tom da pele etc.
festinação	aceleração não controlada dos passos para não cair para frente
fibra motor	fazem parte dos nervos e levam os impulsos produzidos no sistema nervoso (*Ver sistema nervoso no glossário) para os órgãos onde a ação será realizada
fibra sensorial	fazem parte dos nervos e levam as informações obtidas no meio ambiente e no interior do nosso organismo para os locais onde essas informações serão analisadas no Sistema Nervoso Central (*definição de SNC)
fibrilação	o coração bate de forma irregular, muitas vezes muito rápido, causando má circulação do sangue
fibromialgia	doença sem cura que causa muita dor em todo o corpo; não se sabe o que causa essas dores
fibrose	endurecimento que pode ocorrer em qualquer região do corpo, mas que é mais comum na pele, gordura ou músculos
fígar	órgão do sistema digestivo com muitas funções importantes, como metabolizar (processar) e armazenar nutrientes, filtrar micro-organismos e desintoxixcar o corpo 
fisiologia	estuda a atividade e as funções normais do corpo
fisiopatologia	funcionamento da doença
fisioterapeuta	profissional que se dedica a tratar e prevenir problemas com os movimentos do corpo
fisioterapia	técnicas guiadas por um profissional usadas no tratamento de problemas com os movimentos do corpo
fisioterápico	relacionado à fisioterapia (*Verfisioterapia no glossário)
fissurar	fenda ou corte que ocorre em uma parte de um órgão
fissura anal	pequeno corte no ânus e que tem como causas principais a prisão de ventre e fezes muito grandes e duras
flato	gases, pum
flatulência	gases, pum
flora intestinal	conjunto de organismos muito pequenos que vivem em nosso intestino; quando estão em harmonia ajudam no metabolismo e nas defesas do corpo, quando se desequilibram podem causar doenças
fluência verbal	quando a pessoa tem facilidade para encontrar as palavras que quer falar ou usar
fluoxetina	remédio usado para tratar depressão, ansiedade e outros problemas relacionados ao comportamento e à mente
flutuação motor	problemas na coordenação motora e nos movimentos do paciente; um dos efeitos adversos de medicamentos utilizados para tratar a Doença de Parkinson
flutuações não motor	problemas não relacionados aos movimentos do paciente, podem incluir depressão, perda de memória, dificuldade na fala, entre outros
fonação	produção da voz
fonoaudiologia	ciência que estuda a fala; conjunto técnicas guiadas por um profissional usadas para tratar problemas de fala
fonoaudiológico	relacionado à fonoaudiologia (*Ver fonoaudiologia no glossário)
fonoterapia	técnica que utiliza exercícios específicos para estimular a linguagem, fala, audição (ouvir), voz e os músculos dos lábios, língua, bochechas e face
fotofobia	quando a pessoa tem dificuldade para tolerar (aguentar) a luz
fotossensibilidade	sensibilidade à luz, claridade ou ao sol
fratura	quebra do osso em um ou mais pedaços
fratura expor	quando  o osso quebrado rompe os músculos e a pele
fratura óssea	quebra do osso em um ou mais pedaços
freezing	congelamento da caminhada, como se a pessoa estivesse colada ao chão
frequência cardíaca	número de batimentos do coração por minuto
frequência de passar	velocidade com que se dá os passos
função hepática	funcionamento do fígado
função metabólica	reações químicas que acontecem nas células do nosso corpo e que transformam os alimentos em energia
funções vital	funções necessárias para manter a vida; a alimentação e a respiração são exemplos de funções vitais
fuso neuromuscular	pequenas estruturas localizadas nos músculos, que controlam o tônus muscular
gaba	mensageiro químico que regula a agitação do cérebro e do corpo, o que leva a uma sensação de calma; o mesmo que GABA
gânglio	pequenas estruturas (glândulas) que tem a função de defender o organismo de infecções
gânglios de o base	estruturas localizadas no cérebro e relacionadas com o movimento; elas ajudam a planejar e executar movimentos complexos; problemas nessas estruturas podem causar dificuldades de se mover por rigidez, tremores e paralisia
glânglios linfático	pequenas estruturas (glândulas) que têm a função de defender o organismo de infecções; o mesmo que linfonodo
gangrena	morte dos tecidos que pode ter diferentes causas, mas principalmente a falta de irrigação de sangue no local afetado
gasto energético	gasto de energia
gastrite	inflamação do estômago
gastrodinia	dor no estômago
gastropatia	doença do estômago
gene	estruturas responsáveis por carregar as informações necessárias para que nossas características se expressem; a pessoa pode ter um gene que determina que a cor dos seus olhos é azul
gene supressor	gene que reduz as chances de uma célula se tornar um tumor, pois impede a multiplicação descontrolada das células
gênese	origem e desenvolvimento dos seres
genética	ciência que estuda a transmissão das características hereditárias (passadas de pais para filhos) ao longo das gerações
genótipo	características pessoais um indivíduo, passadas dos pais para os filhos
gengivite	inflamação nas gengivas
genitália	órgãos sexuais internos e externos tanto no homem quanto na mulher
genoma	conjunto de genes de uma célula ou organismo vivo; uma célula humana contém dois genomas, um materno e outro paterno
germe	organismos muito pequenos, como bactérias, fungos, vírus, parasitas etc. que podem causar doenças
gerontologia	estudo de diferentes fenômenos relacionados ao envelhecimento do ser humano
gerontológica	relacionado à Gerontologia (*Ver Gerontologia no glossário)
gh	hormômio do crescimento; substância que faz as crianças e adolescentes crescerem
glândula	estruturas do corpo humano que liberam substâncias (hormônios) na corrente sanguínea
glândula adrenal	estruturas que produzem e lançam no sangue substâncias que regulam o nosso corpo chamadas hormônios
glândula digestivo	órgãos do corpo humano que produzem e liberam algumas substâncias que ajudam no processo de digestão dos alimentos; o fígado é um exemplo de glândula digestiva
glândula endócrina	estruturas que produzem e lançam no sangue substâncias que regulam o nosso corpo chamadas hormônios
glândula hipófise	localizada na base do crânio, é considerada a glândula mais importante, pois produz vários hormônios (substâncias) que regulam o funcionamento do nosso corpo
glândula lacrimal	pequena estrutura em forma de amêndoa, localizada no olho, que produz lágrimas 
glândula salivar	estruturas localizadas na boca, que produzem saliva para lubrificar a boca e a garganta
glândula sebácea	estruturas localizadas nos pelos em todas as partes do corpo, que produzem e liberam um óleo que lubrifica e protege a pele
glândula sudorípara	estruturas localizadas de baixo da pele que produzem suor; grande parte delas está localizada na testa, nas axilas, na palma das mãos e na planta dos pés
glândula suprarrenal	estruturas que produzem e lançam no sangue substâncias que regulam o nosso corpo chamadas hormônios
glândula tireoide	localizada no pescoço, age na função de órgãos importantes como o coração, cérebro, fígado e rins, além de interferir em várias outras funções como o crescimento das crianças e adolescentes, ciclo menstrual da mulher e muito mais
glaucoma	grupo de doenças nos olhos que pode causar cegueira
glicemia	açúcar no sangue
glicose	açúcar
glicosúria	açúcar na urina
glioblastoma multiforme	tumor mais comum no cérebro
globo pálido	estrutura localizada no cérebro que afeta os movimentos, o equilíbrio e a caminhada
glóbulos branco	defendem o organismo contra infecções como gripes e refriados e outras doenças; o mesmo que leucócitos
glóbulos vermelho	células do sangue importantes para levar oxigênio aos tecidos do corpo; também são responsáveis pela cor vermelha do sangue; o mesmo hemácias ou eritrócitos
glossalgia	dor na língua
gluconato de clorexidina	substância para bochecho, usada para combater infecções na boca
glutamato	*sem definição
gocovri	marca de remédio (amantadina) usado para tratar a Doença de Parkinson e outras doenças  
grupo controlo	grupo de pessoas que não será testado ou receberá o remédio em um experimento ou estudo sobre uma doença; esse grupo toma o que chamamos de placebo (*Ver placebo no glossário)
grupo controlo	grupo de pessoas que não será testado ou receberá o remédio em um experimento ou estudo sobre uma doença; esse grupo toma o que chamamos de placebo (*Ver placebo no glossário)
grupo de controlo	grupo de pessoas que não será testado ou receberá o remédio em um experimento ou estudo sobre uma doença; esse grupo toma o que chamamos de placebo (*Ver placebo no glossário)
grupo de apoio de o idoso	grupo de pessoas que promove ações que buscam melhorar a qualidade de vida dos idosos
grupo de risco	pessoas ou grupos de pessoas sujeitas a fatores (características biológicas e/ou sociais e culturais) que aumentam as chances de elas desenvolverem certas doenças. Os idosos são considerados grupo de risco para várias doenças, como gripe, doenças no coração etc.
halitose	mau hálito
hemácias	células do sangue importantes para levar oxigênio aos tecidos do corpo; também são responsáveis pela cor vermelha do sangue; o mesmo que eritrócitos ou glóbulos vermelhos
hematemese	vômito de sangue
hematologia	estudo do sangue
hematológico	relacionado ao sangue
hematologista	médico que estuda e trata das doenças do sangue
hematoma	quando o sangue que sai da veia acumula em um órgão ou tecido após um trauma. Quando batemos o braço em um objeto e o local fica com uma mancha roxa, é porque sangue se acumulou no local da batida.
hematoma subdural agudo	o sangue acumula entre o cérebro e sua camada de proteção
hematúria	sangue na urina
hemialgia	dor principalmente na cabeça, que pode ser muito forte; também conhecida como enxaqueca
hemianopsia	problema de visão em que metade do campo de visão do olho é afetado por cegueira ou visão reduzida
hemibalismo	movimentos sem controle, rápidos e anormais dos membros do corpo, apenas de um lado do corpo, podendo também ocorrer no tronco e na cabeça; a causa mais comum é o derrame
hemicoreia	movimentos sem controle, rápidos e anormais dos membros do corpo, apenas de um lado, podendo também ocorrer no tronco e na cabeça; a causa mais comum é o derrame
hemicrânia paroxística	crises de dor de cabeça
hemiatrofia	atrofia (falta de desenvolvimento) de metade do corpo ou de uma parte do corpo, como atrofia de metade do rosto ou de metade da língua
hemiparesia	paralisia parcial ou diminuição da força em metade do rosto, em um dos braços ou uma das pernas
hemiplegia	paralisia de um lado do corpo
hemisfério cerebral direito	lado direito do cérebro,  que cuida de habilidades relacionadas ao espaço, reconhecimento de faces (rostos), visualização mental (quando imainamos situações, pessoas e objetos em nossa mente) e música
hemisfério cerebral esquerdo	lado esquerdo do cérebro, que cuida das habilidades de linguagem (fala, escrita, leitura, escuta), matemática e lógica
hemisfério direito	lado direito do cérebro,  que cuida de habilidades relacionadas ao espaço, reconhecimento de faces (rostos), visualização mental (quando imainamos situações, pessoas e objetos em nossa mente) e música
hemisfério esquerdo	lado esquerdo do cérebro
hemisférios cerebral	lado direito e lado esquerdo do cérebro
hemodiálise	tratamento que remove as toxinas (substâncias que provocam danos à saúde) do sangue
hemoglobina	substância de cor vermelha presente no sangue e que transporta oxigênio por todo o corpo; se essa substância estiver baixa, isso pode indicar que a pessoa está com anemia
hemograma	exame de sangue realizado para avaliar a quantidade de células de sangue de uma pessoa, podendo indicar se a pessoa tem doenças como anemia, infecções ou leucemia (tipo de câncer)
hemorragia	sangramento anormal e em grande quantidade
hepatite	inflamação do fígado
hepatoesplenomegalia	aumento do baço e do fígado
hepatotoxidade	dano no fígado causado por substâncias tóxicas
hepatotoxina	qualquer substância tóxica que pode prejudicar o fígado
herança autossômica dominante	*sem definição
herança autossômica recessivo	*sem definição
herança genética	propriedades dos seres vivos de transmitirem suas características aos seus descendentes (filhas e filhos)
herança mendeliano	*sem definição
herbicida	produto químico utilizado na agricultura para o controle de ervas daninhas
hereditariedade	quando os genes e características dos pais são passados para os filhos/filhas
hereditariedade mendeliano	*sem definição
hereditário	passa de pais para filhos/filhas
heredodegeneração	processo degenerativo, que vai piorando com o tempo, e hereditário, que passa de pais para filhos/filhas
hérnia	saliência de um órgão ou parte dele através da parede que o contém; podem aparecer em diferentes regiões do corpo
hidrocefalia	aumento anormal de líquido dentro do crânio
hidropenia	falta de água no corpo (desidratação)
hiperatividade	quando a pessoa fica com energia demais, que pode ser motora (física, muscular) ou mental (muitos pensamentos ao mesmo tempo); agitação
hipercalcemia	nível de cálcio no sangue mais alto que o normal
hipercinesia	movimentos descontrolados, muitos movimentos ao mesmo tempo
hipercinético	relacionado a movimentos anormais
hiperêmese	vômito excessivo
hiperestesia	aumento da sensibilidade dos difefrentes sentidos (audição, olfato, paladar, tato e visão)
hiperglicemia	níveis altos de açúcar no sangue
hiperplasia	aumento do número de células em um órgão ou tecido sem caracterizar câncer
hiperplasia prostática	próstata aumentada, o que pode causar dificuldades para urinar
hiperreflexia	aumento dos reflexos dos músculos e tendões (tecido que prende o músculo ao osso)
hipersexualidade	vontade incontrolável de fazer sexo, que pode afetar o trabalho, a saúde e os relacionamentos
hipertensão	pressão alta
hipertensão arterial sistêmica	pressão alta
hipertensão pulmonar	aumento das pressões nos vasos do pulmão
hipertenso	pessoa com pressão alta
hipertireoidismo	ocorre quando a glândula tireoide (*Ver glândula tireoide no glossário) produz mais hormônios que o nosso corpo precisa
hipertonia	aumento do tônus muscular (contração com o músculo em repouso)
hipertropia	aumento do tecido causado pelo aumento da célula
hiperventilação	aumento da ventilação dos pulmões (renovação do ar) além das necessidades normais do nosso corpo
hipoatitvidade	diminuição da atividade ou falta de interesse por derterminada(s) atividade(s)
hipocalcemia	níveis muito baixos de cálcio no sangue
hipocampo	parte do cérebro responsável pelo aprendizado e memória; o hipocampo é importante para a formação de novas memórias
hipocinesia	capacidade reduzida para se movimentar
hipoestesia	diminuição da sensibilidade dos difefrentes sentidos ((audição, olfato, paladar, tato e visão)
hipófise	localizada na base do crânio, é considerada a glândula mais importante, pois produz vários hormônios que regulam o funcionamento do nosso corpo
hipofonia	redução do volume da voz
hipoglicemia	diminuição da quantidade de açúcar no sangue
hipomimia	dificuldade para mover os músculos da face e fazer gestos
hipoquinesia	capacidade reduzida dos movimentos
hiporreflexia	diminuição dos reflexos dos músculos e tendões (tecido que prende o músculo ao osso)
hiposmia	perda da capacidade de sentir cheiros
hipossalivação	falta de saliva, boca seca
hipotálamo	estrutura localizada no cérebro relacionada com a emoção e o comportamento
hipotensão	pressão baixa
hipotensão ortostática	tontura ao levantar (ficar de pé) porque a pressão cai
hipotensão postural	tontura ao levantar (ficar de pé) porque a pressão cai
hipotenso	pessoa com pressão baixa
hipotireoidismo	ocorre quando a glândula tireoide (*Ver glândula tireoide no glossário) produz nais hormônios do que o corpo precisa
hipotonia	diminuição do tônus muscular (contração com o músculo em repouso)
hipoxemia	falta de oxigênio no sangue
hipoxia	falta de oxigênio suficiente no sangue para que o nosso corpo continue funcionando bem
histerectomia	cirurgia que remove parte ou todo o útero
histerectomia abdominal	cirurgia que remove o útero ou parte dele através de um corte no abdômem (barriga)
histologia	estudo das funções dos tecidos e células do corpo
histológico	relacionado à histologia (*Ver histologia no glossário)
histopatologia	estudo de como uma doença afeta um conjunto de células
histopatológico	relacionado à histopatologia (Ver histopatologia no glossário)
holístico	busca compreender os fenômenos analisando vários fatores e não apenas um lado das coisas
holocraniano	em todo o crânio/cabeça
homostasia	procedimentos feitos para parar um sangramento
hormônio	substâncias que regulam o funcionamento de diversas funções do nosso organismo; funcionam como mensageiros que dizem ao nosso corpo como ele deve funcionar
idiopático	sem causa conhecida
implante dentário	são suportes de metal que substituem a raíz de um dente para que o dentista possa colocar dentes postiços no local
impotência sexual	se refere a qualquer condição ou sintoma que prejudique a vida sexual do indivíduo
imune	estar livre ou protegido de uma doença. A pessoa pode ficar imune depois de pegar a doença e desenvolver anticorpos (defesas) contra a doença.
imunidade	sistema de defesa do organismo; é um conjunto de mecanismos que defendem o nosso corpo de infecções causadas por vírus, bactérias etc
imunoglobulina	proteínas que têm como principal função a defesa do organismo; o mesmo que anticorpos
imunologia	ramo da biologia que estuda os fenômenos, a organização e o funcionamento do sistema imunológico
imunológico	relacionado à imunidade (*Ver imunidade no glossário)
imunossupressor	remédios usados para evitar que o nosso corpo rejeite (não aceite) um órgão transplantado (recebido de outra pessoa)
inapetência	falta de apetite (vontade de comer)
incapacitar	pessoa que não tem condições físicas e/ou psicológicas para realizar determinadas tarefas
incapacitante	aquilo que incapacita; uma doença incapacitante impede que a pessoa consiga realizar suas atividades normais do dia a dia 
incidência	número de casos de uma doença (ou grupo de doenças) numa população definida durante um intervalo de tempo específico
incisão	corte realizado por um médico com o objetivo de permitir o acesso a área a ser operada
inclusões intraneuronal	estruturas que se formam dentro dos neurônios (*Ver neurônios no glossário)
incontinência de urgência	vontade forte de urinar, de uma hora para outra, causada por contrações na bexiga e com vazamentos de urina antes que a pessoa consiga chegar ao banheiro
incontinência fecal	a pessoa não consegue controlar a eliminação das fezes
incontinência urinária	perda de controle da bexiga, que pode ser desde gotas de xixi após espirrar, tossir ou rir até a total  falta de capacidade de controlar a urina
índice de apgar	medida que avalia como está um bebê recém-nascido, feita 1 minuto após o nascimento e repetida depois de 5 minutos
índice de lawton	mede a capacidade dos idosos de realizarem atividades mais complexas que as atividades básicas da vida diária
índice glicêmico	mede o tempo que o carboidrato de um alimento demora para ser absorvido pelo intestino
infarte	ataque do coração; ocorre quando o fluxo de sangue deixa de chegar ao músculo do coração, fazendo com que esse músculo seja danificado ou morra
infarto	ataque do coração; ocorre quando o fluxo de sangue deixa de chegar ao músculo do coração, fazendo com que esse músculo seja danificado ou morra
infarto de o miocárdio	ataque do coração; ocorre quando o fluxo de sangue deixa de chegar ao músculo do coração, fazendo com que esse músculo seja danificado ou morra
infecção	entrada e o desenvolvimento de um agente infeccioso (bactérias, vírus, entre outros) no organismo ou a multiplicação de um desses agentes que já esteja no nosso corpo
infecção endêmica	quando a doença está presente em uma área/região sempre, o tempo todo, durante anos e anos. A dengue é uma doença endêmica no Brasil, pois está presente aqui por muitos anos.
infecção urinária	infecção causada quando bactérias que vivem no nosso corpo vão para a bexiga, podendo chegar até os rins, causando dor e queimação para urinar; a infecção é mais leve na bexiga, mas pode ser grave quando chega aos rins
infeccioso	que causa infecção
infectologia	especialidade médica que estuda e trata doenças causadas por vírus, bactérias, protozoários, fungos e outros animais
infectologista	médico que estuda e trata doenças causadas por vírus, bactérias, protozoários, fungos e outros animais
inflamação	é uma reação de defesa do nosso corpo diante de uma agressão, que pode vir de agentes físicos (cortes, contusões, queimaduras), químicos (agentes irritantes, corrosivos etc.) e biológicos (infecções em geral causadas por vírus, bactérias etc.)
inflamatório	que causa inflamação (*Ver inflamação no glossário)
informação tóxico farmacológica	*sem definição
infraumbilical	localizado abaixo do umbigo
infusão	introduzir fluido (líquido) nas veias ou nos tecidos do corpo
inibidor	elementos capazes de diminuir ou interromper a atividade de uma substância
insônia	dificuldade para pegar no sono e/ou continuar dormindo
instabilidade postural	dificuldade para manter a postura (tendência de cair para a frente e para trás)
insuficiência cardíaca	condição em que o coração não consegue de bombear a quantidade de sangue necessária para o corpo
insuficiência renal	problema com o funcionamento dos rins
insulina	hormônio que controla a quantidade de glicose (açúcar) no sangue
interação medicamentoso	quando há uso de vários remédios juntos e  o efeito de um dos remédios pode atrapalhar o efeito do outro
intercostal	entre as costelas
internação hospitalar	pacientes que são admitidos no hospital para ocupar um leito por um período igual ou maior que 24 horas
intestino	órgão em forma de tubo que vai desde o final do estômago até o ânus, permitindo a passagem dos alimentos digeridos, facilitando a absorção dos nutrientes e a eliminação dos resíduos (pelas fezes)
intestino delgar	primeira parte do intestino, que liga o estômago ao intestino grosso, e a mais comprida, onde ocorre a a absorção de parte da água e da maior parte dos nutrientes dos alimentos
intestino grosso	segunda parte do intestino e a menor, mas a mais importante para absorver a água
intraçar	dentro da célula
intracraniano	dentro do crânio
intramuscular	injeção aplicada dentro de um músculo
intratável	que não tem tratamento
intravenoso	injeção aplicada dentro das veias; o mesmo que endovenoso
intolerância a o lactose	quando o organismo não consegue digerir o açúcar presente no leite, chamado de lactose, causando sintomas como cólica, gases e diarreia
introlerância a o glúten	quando o organismo não consegu digerir o glúten, que é uma proteína presente no trigo, no centeio e na cevada; nessas pessoas o glúten danifica as paredes do intestino delgado, provocando diarreia, dor e inchaço abdominal, além de dificultar a absorção de nutrientes
introlerância a o medicamento	quando o organismo da pessoa não aceita bem o remédio e ela passa mal, podendo vomitar, ter diarreia e/ou dor de cabeça; em casos mais graves a pessoa pode ter uma reação alérgica ao remédio
intolerância medicamentoso	quando o organismo da pessoa não aceita bem o remédio e ela passa mal, podendo vomitar, ter diarreia e/ou dor de cabeça; em casos mais graves a pessoa pode ter uma reação alérgica ao remédio
íntrons	regiões do DNA que não codificam proteínas
intubar	colocar tubo ou sonda no paciente; o mesmo que entubar
intubação	procedimento em que o médico insere um tubo na traqueia para ajudar o paciente a respirar; o mesmo que entubação
intubação orotraqueal	procedimento em que o médico insere um tubo na traqueia para ajudar o paciente a respirar; o mesmo que entubação
intubação traqueal	procedimento em que o médico insere um tubo na traqueia para ajudar o paciente a respirar; o mesmo que entubação
intubação endrotraqueal	procedimento em que o médico insere um tubo na traqueia para ajudar o paciente a respirar; o mesmo que entubação
ipdm	Instabilidade Postural e Dificuldade na Marcha: desequilíbrio e dificuldade para caminhar
íris	parte mais visível (e colorida) do olho, e tem como função principal controlar os níveis de luz
isquemia cardíaca	acontece quando o sangue não consegue passar pelos vasos que levam sangue até o coração; geralmente, é causada pela presença de placas de gordura dentro dos vasos, que quando não são tratadas podem romper e entupir o vaso, causando dor e aumentando as chances de infarto
isquemia cerebral	acontece quando não chega sangue suficiente até o cérebro, diminuindo a quantidade de oxigênio que chega ao cérebro
isquemia de o miocárdio	acontece quando o sangue não consegue passar pelos vasos que levam sangue até o coração; geralmente, é causada pela presença de placas de gordura dentro dos vasos, que quando não são tratadas podem romper e entupir o vaso, causando dor e aumentando as chances de infarto
isquemia	quando o sangue não chega a um órgão ou tecido do corpo
jejum	deixar de comer por períodos do dia; pode ser por algumas horas, um dia inteiro ou dias
janela imunológica	período entre o contato com o agente infeccioso (vírus, bactéria etc.) e o tempo que o organismo leva para produzir quantidade suficiente de anticorpos (defensores) contra a infecção capazes de serem identificadas nos exames feitos em laboratório
joelho fletido	joelho(s) inclinado(s)
lacrimal	relacionado à lágrima
lacrimejamento	grande volume de lágrimas nos olhos
labirinto	estrutura da orelha interna formada pela cóclea (responsável pela audição/ouvir) e pelo vestíbulo e canais semicirculares (responsáveis pelo equilíbrio)
labirintite	infecção ou inflamação de uma estrutura interna da orelha chamada de labirinto, que é responsável pela audição (como ouvimos) e pelo equilíbrio do corpo
laparotomia	técnica cirúrgica que faz um corte no abdômem (barriga) para o médico ter acesso aos órgãos internos da região
lapso de memória	falhas na memória; esquecimento
laringe	órgão localizado na região da garganta, entre a traqueia e a base da língua, que ajuda na respiração e produz sons
laxante	remédio ou substância que estimula o movimento e a eliminação das fezes
laxativo	remédio ou substância que estimula o movimento e a eliminação das fezes
lesão	ferimento, machucado
letalidade	representa o risco que as pessoas com uma doença têm de morrer por essa mesma doença
letargia	estado de cansaço com diminuição da energia, da capacidade de pensar e da motivação
leucemia	tipo de câncer que afeta as células do sangue, também conhecidas como leucócitos, que são as células de defesa do organismo
leucócitos	defendem o organismo contra infecções, doenças, alergias, resfriados; o mesmo que glóbulos brancos
leucopenia	diminuição na contagem de glóbulos brancos (leucócitos); número de células de defesa do sangue abaixo do normal
levodopa	remédio que aumenta a quantidade de dopamina (*Ver dopamina no glossário) no corpo humano
ligamento	estrutura que prende um osso ao outro
linfócitos	tipo de célula de defesa do organismo, que atua contra doenças como câncer e infecções causadas por vírus, como as gripes; fazem parte dos glóbulos brancos
linfoma	tipo de câncer que afeta os linfócitos, que são células responsáveis por proteger o corpo de infecções e doenças
linfonodo	pequenas estruturas (glândulas) que tem a função de defender o organismo de infecções
líquido cefalorraquidiano	líquido que banha o cérebro e a medula espinhal
líquido cérebro espinal	líquido que banha o cérebro e a medula espinhal
líquor	líquido que banha o cérebro e a medula espinhal
lipídeo	o mesmo que gordura
lipídio	o mesmo que gordura
lobo frontal	parte do cérebro responsável pela coordenação motora voluntária (movimentos que queremos fazer), pela coordenação dos músculos, pelos movimentos da cabeça e do pescoço e pelas funções da linguagem (como nos comunicamos)
lóbulo frontal	parte do cérebro responsável pela coordenação motora voluntária (movimentos que queremos fazer), pela coordenação dos músculos, pelos movimentos da cabeça e do pescoço e pelas funções da linguagem (como nos comunicamos)
lobo occipital	parte do cérebro responsável por perceber e reconhecer pessoas e objetos; diretamente ligado ao nosso sentido da visão (como enxergamos)
lóbulo occipital	parte do cérebro responsável por perceber e reconhecer pessoas e objetos; diretamente ligado ao nosso sentido da visão (como enxergamos)
lobo parietal	parte do cérebro responsável por processar as sensações (sentir um abraço), as memórias (lembrar o nome de um amigo ou de um momento feliz) e a orientação espacial (saber onde está em uma nova cidade)   
lóbulo parietal	parte do cérebro responsável por processar as sensações (sentir um abraço), as memórias (lembrar o nome de um amigo ou de um momento feliz) e a orientação espacial (saber onde está em uma nova cidade)   
lobo temporal	localizados dos dois lados do cérebro, são responsáveis por várias funções, como reconhecer rostos, usar a linguagem, compreender sons, manter o equilíbrio e regular as emoções (motivação, raiva, ansiedade, prazer etc.)
lóbulo temporal	localizados dos dois lados do cérebro, são responsáveis por várias funções, como reconhecer rostos, usar a linguagem, compreender sons, manter o equilíbrio e regular as emoções (motivação, raiva, ansiedade, prazer etc.)
lombalgia	dor da região lombar da coluna; dor nas costas
lombar	parte de baixo das costas/coluna
lrrk2	gene considerado pelos especialistas como uma das causas mais comuns da Doença de Parkinson
luxação	lesão (machucado) em que uma articulação (junta) é deslocada da posição normal, provocando dor, limitação nos movimentos, inchaços e hematomas (machas roxas)
macrogol	remédio para tratar prisão de ventre em crianças e adultos
macroscópico	grande o suficiente para ver a olho nu (sem uso de instrumentos)
magnésio	mineral encontrado em vários alimentos como sementes, amendoim e leite, e que tem várias funções no organismo, como regular o funcionamento dos nervos e dos músculos e ajudar no controle do açúcar no sangue
mal de alzheimer	nome a ser evitado por poder causar preconceito ou discriminação. Usar Doença de Alzheimer ou só Alzheimer.
mal de parkinson	nome a ser evitado por poder causar preconceito ou discriminação; usar Doença de Parkinson (*Ver Doença de Parkinson no glossário)
malformação congênita	defeito de nascença, transmitido pelos  pais ou produzido por algo no meio ambiente durante a gravidez
mandíbula	parte dos ossos da cabeça que se mexe quando a pessoa fala ou come, queixada
manifestações clínicas	conjunto de sinais e sintomas de uma doença
manobra de valsava	quando a pessoa assopra o ar para fora estando com a boca e e o nariz tapados e sente o ar forçar os ouvidos
manômetro	aparelho usado para medir pressão de líquidos e gases
marcar passo	aparelho colocado dentro do peito da pessoa, em uma operação, para ajudar o coração a bater de modo normal
marcha	movimento da caminhada de uma pessoa
marcha patológica	movimento anormal da caminhada de uma pessoa
máscara parkisoniana	sintoma da doença de Parkinson e outras doenças; o rosto parece uma máscara porque fica sem expressão, e o olhar parado, vago e fixo
massa branco	parte do cérebro que funciona quando a pessoa quer fazer algo
massa cinzento	parte do cérebro que coordena as atividades dos músculos da pessoa
mastigação	ato de esmagar a comida com os dentes dentro da boca
material genético	conjunto de genes de um organismo vivo
medicação	remédio
medicalização	quando o modo de vida dos homens é governado pela medicina, quanto a ideias, regras de higiene, de moral e de costumes
medicamento de uso contínuo	remédio que a pessoa não pode parar de tomar nunca, para não ficar doente ou morrer
medicamento genérico	remédio com a mesma fórmula e efeito  de um outro remédio original, de referência, sem o nome de fantasia
medula adrenal	a pesquisar
medula espinal	tem a função de enviar mensagens de partes do corpo até o cérebro para produzir movimentos e reflexos do nosso corpo
medula espinhal	tem a função de enviar mensagens de partes do corpo até o cérebro para produzir movimentos e reflexos do nosso corpo
medula oblongo	liga e faz a comunicação entre o cérebro e a medula espinhal
medula óssea	tecido localizado dentro dos ossos, também conhecido como tutano, que produz células de sangue
melanina	substância que dá cor à pele e aos cabelos da pessoa
melanócito	célula que fabrica a substância que dá cor à pele e aos cabelos da pessoa
melanona	câncer de pele muito perigoso
melanúria	quando a urina fica escura porque apresenta a substância que dá cor à pele e aos cabelos da pessoa
melatonina	hormônio que organiza sas funções do corpo quando estamos acordados e durante o sono
melena	fezes escuras por causa de sangue ou hemorragia
membrana celular	estrutura que tem em volta da célula, funcionando como barreira e filtro
membrana plasmática	estrutura que separa a célula do ambiente; é uma camada muito fina e delicada que "fiscaliza" todas as substâncias e partículas que entram e saem da célula
membro inferior	quadril, pernas e pés
membro superior	braços, antebraços, punhos e mãos
meninge	três camadas que envolvem e protegem o cérebro, a medula espinhal e outras partes do sistema nervoso central
meningite	inflamação das camadas de proteção que envolvem o cérebro dentro da cabeça da pessoa
menopausa	fase da vida  em que a mulher para de ter menstruação todo o mês e que não consegue mais  engravidar
mesencéfalo	a pesquisar
mesilato de rasagilina	medicamento ver
metabolismo	reações que acontecem nas células do nosso corpo e que transformam o que a pessoa come em energia
metástase	quando um câncer que se espalha pelo corpo da pessoa
metoclopramida	remédio para tratar enjoos, ânsias e vômitos
mialgia	dor nos músculos
miastenia	fraqueza dos músculos com paralisia que vai aumentando em diferentes partes do corpo, principalmente no  rosto, língua, garganta
micção	urinar, fazer xixi
microalbuminúria	a pesquisar
micróbio	organismos muito pequenos, que não se consegue enxergar, como vírus e bactérias
microbioma	a pesquisar
microbiota intestinal	conjunto organismos muito pequenos que vivem em nosso intestino; quando estão em harmonia ajudam no metabolismo e nas defesas do corpo, quando se desequilibram podem causar doenças
micróglia	a pesquisar
micrografia	a pesquisar
micronutriente	a pesquisar
microrganismo	a pesquisar
micro organismo	a pesquisar
microscópico	muito pesqueno, visto apenas com um microscópio (aparelho com lentes que permite a pessoas enxergar coisas muito pequenas)
microscópio	aparelho com lentes que permite a pessoa enxergar coisas muito pequenas
mielina	proteção que fica em volta dos nervos
miocárdio	músculo que controla as contrações (batimentos) do coração
miocimia	a pesquisar
mioclonia	a pesquisar
miologia	estudo dos músculos
miomatose	a pesquisar
miopatia	qualquer doença nos músculos
miorrexia	ruptura (rompimento) de um músculo
miosite	inflamação de um músculo
miossarcoma	tumor, câncer no músculo
mitocôndria	organismo muito pequeno que converte os alimentos que comemos em energia para as células
molécula	a menor partícula em que um elemento  pode ser dividido sem mudar suas propriedades; é como se fossem pequenos tijolos, que não podem ser quebrados, de uma estrutura maior
moléstia	doença
monoplegia	paralisia (perda do movimento) de um membro do corpo da pessoa
morbidade	número de casos de uma doença em uma população
mórber	que tem a ver com a morte
morfina	remédio muito forte usado para aliviar dores que causam muito sofrimento
motricidade	movimentação do corpo
movimento voluntário	movimento(s) do corpo que se realizam por vontade própria
movimento involuntário	movimento(s) do corpo que acontecem sem pessoa desejar
mptp	a pesquisar
muco	ranho ou secreção
mucosa	revestimento úmida da pele, como dentro do nariz e boca
mucosite	inflamação dos revestimentos úmidos da pele, como dentro do nariz e boca
multifatorial	que tem vários fatores (coisas) envolvidos
muscular	a pesquisar
músculo	os músculos são como o motor de um carro, pois proporcionam a força necessária para movimentar as várias partes do corpo e para manter o equilíbrio
músculo estriar cardíaco	músculo que controla as contrações produzidas pelos batimentos do coração; o mesmo que miocárdio
músculo estriar	músculos voluntários que movem os ossos e dão sustentação ao esqueleto
músculo estriar esquelético	músculos voluntários que movem os ossos e dão sustentação ao esqueleto
músculo esquelético	músculos voluntários (que controlamos) que movem os ossos e dão sustentação ao esqueleto
músculo visceral	músculos involuntários (que não controlamos) que movimentam os órgãos internos do nosso corpo, como o estômago etc.
músculo não estriar	músculos involuntários (que não controlamos) que movimentam os órgãos internos do nosso corpo, como o estômago etc.
músculo liso	músculos involuntários (que não controlamos) que movimentam os órgãos internos do nosso corpo, como o estômago etc.
mutação	alteração, mudança
mutação genética	corresponde à alteração de um gene, podendo afetar seu funcionamento normal
nac	a pesquisar
narcolepsia	quando a pessoa adormece de repente mas logo acorda
nasogástrico	do anriz e do estômago
náusea	enjoo ou vontade de vomitar
nb	a pesquisar
necropsia	exame de um corpo morto
necrose	morte de uma célula
nefrolitíase	pedra nos rins
nefrologia	estudo do rim, suas funções e doenças
nefrologista	médico que trata doenças dos rins
néfron	célula do rim
nefrose	perturbação renal
neoadjuvante	tratamento inicial e preparatório para um outro principal
neoestriar	a pesquisar
neoplasia	crescimento anormal de um grupo de células; o mesmo que tumor
neoplasma	aumento anormal, pode ser um tumor (*definição de tumor) ou um cisto (*definição de cisto)
nerlurin	a pesquisar
nervo	são semelhantes a fios que se dividem e se ligam a quase todas as partes do corpo, transporando mensagens dos órgãos dos sentidos para o cérebro e instruções do cérebro para outras partes do corpo
nervo craniano	a pesquisar
nervo eferente	a pesquisar
nervo espinhal	a pesquisar
nervo facial	a pesquisar
nervo óptico	a pesquisar
nervo periférico	a pesquisar
nervo radial	a pesquisar
nervo aferente	a pesquisar
neuralgia	dor em um nervo
neurite	inflamação em um nervo
neuroacantocitose	a pesquisar
neurocirurgião	médico que opera em casos de problemas no cérebro e em outras parte sistema nervoso central
neurocomportamental	a pesquisar
neurodegeneração	a pesquisar
neurodegenerativo	a pesquisar
neuroendoscopia	a pesquisar
neuroestimulador	a pesquisar
neurofarmacologia	a pesquisar
neuróglia	a pesquisar
neuroléptico	a pesquisar
neurologia	estudo do sistema nervoso, suas funções e doenças
neurologista	médico especializado no estudo do sistema nervoso, suas funções e doenças
neuroma	a pesquisar
neuromuscular	a pesquisar
neurônio	
neurônio colinérgico	a pesquisar
neurônio dopaminérgico	neurônios que produzem e liberam dopamina 
neurônio gabaérgico	a pesquisar
neuropatia	a pesquisar
neuropatia autônoma	doenças que afetam os nervos que regulam os processos do corpo; a pessoa pode sentir tontura, ter problema para controlar a bexiga, intestino preso, entre outros sintomas
neuropatia autonômica	doenças que afetam os nervos que regulam os processos do corpo; a pessoa pode sentir tontura, ter problema para controlar a bexiga, intestino preso, entre outros sintomas
neuropática	
neuroplastia	a pesquisar
neuroproteção	mecanismos e estratégias usados para proteger os neurônios contra danos causados por doenças
neuropsicológico	a pesquisar
neuroquímico	a pesquisar
neurose	a pesquisar
neurotransmissor colinérgico	a pesquisar
neurotransmissor noradrenérgico	a pesquisar
neurotransmissor serotoninérgico	a pesquisar
neutrotransmissor	a pesquisar
nicotina	substância que tem no fumo e em cigarros e assemelhados
nictúria	a pesquisar
nistagmo	movimento descontrolado dos olhos que pode fazer o olho mover-se de um lado para outro, para cima e para baixo ou em círculos
nível sérico	a pesquisar
noctúria	fazer xixi  muitas vezes durante a noite
noradrenalina	a pesquisar
norepinefrina	a pesquisar
núcleo	a pesquisar
núcleo accumbem	a pesquisar
núcleo caudar	a pesquisar
núcleo lenticular	a pesquisar
núcleo lentiforme	a pesquisar
núcleo putâmem	a pesquisar
núcleos de o base	partes do cérebro que se ligam e que cuidam dos movimentos e dos pensamentos
nurr1	a pesquisar
nutrição	alimentação
nutricional	que tem a ver com alimentação
nutricionista	profissional formado em faculdade e que  cuida da alimentação de uma pessoa
nutrólogo	a pesquisar
obnubilação	a pesquisar
óbito	morte
obesidade	peso acima do normal
obstipação	prisão de ventre; dificuldade para evacuar, dificuldade para fazer cocô
ocluir	fechar
oclusão	fechamento
oclusão carotídea	a pesquisar
ocupacional	que tem a ver com o trabalho ou com o que a pessoa faz
odontologia	especialidade médica que cuida da saúde da boca das pessoas
odontológico	que tem a ver com a saúde da boca de uma pessoa
odontólogo	profissional graduado que cuida da saúde da boca de uma pessoa
oleaginoso	ricas em óleos ou gorduras
oftálmico	dos olhos
oftalmologia	parte da medicina que cuida das doenças e tratamento dos olhos
oftalmológico	médico que cuida das saúde dos olhos das pessoas
oftalmologista	médico especializado nas doenças e tratamento dos olhos
oftalmoparesia	a pesquisar
oftalmoparesia vertical suprir	dificuldade para olhar para baixo
olfanação	a pesquisar
olfativo	que tem a ver com a capacidade de sentir cheiros
olfato	um dos cinco sentidos; processo de sentir cheiros
oligocinesia	a pesquisar
oligúria	diminuição ou ausência de urina
orientação alopsíquica	a pesquisar
orientação espacial	capacidade de se orientar no espaço ou ambiente
orientação temporal	capacidade de se orientar no tempo ou épocas
ortodontista	dentista que cuida do posicionamento correto dos dentes
ortopneia	dificuldade de respirar a menos que esteja de pé
ossififcação	processo de formação do osso
osteo	relacionado ao osso
osteopatia	a pesquisar
osteopenia	problema de saúde em que os ossos diminuem e enfraquecem
osteoporose	doença em que os ossos ficam porosos e fracos
otite	infecção no ouvido
palato	céu da boca
paladar	sentir gostos
palato duro	a pesquisar
palato mole	a pesquisar
palidectomia	a pesquisar
palidotomia	a pesquisar
palilalia	a pesquisar
palpação	apalpar (tocar) com a palma da mão ou com os dedos
pálpebra	parte do olho acima dos cílios ou pestanas
palpitação	batimento acelerado do coração
pâncreas	a pesquisar
pancreatite	a pesquisar
pandemia	quer dizer que uma doença se espalhou para vários países, como aconteceu com o coronavírus
parada cardiorrespiratória	a pesquisar
paralisia	perda da capacidade de movimento de um músculo, que pode ser causada por doenças no próprio músculo ou pot doenças no sistema nervoso
paralisia agitante	como a Doença de Parkinson era chamada antigamente
paralisia cerebral	a pesquisar
paralisia facial	a pesquisar
paralisia supranuclear progressiva	a pesquisar
parâmetros cinemático	a pesquisar
parâmetros eletromiográfico	a pesquisar
parâmetros espaço temporal	a pesquisar
paranoia	a pesquisar
parapesia	paralisia (perda da capacidade de movimento) na metade de baixo do corpo
paraplegia	paralisia (perda da capacidade de movimento) na metade de baixo do corpo
parassimpatomimético	a pesquisar
parênquia hepático	tecido do fígado
parênquima cerebral	tecido do cérebro
parestesia	sensação de latejamento, formigamento ou dormência em uma região do corpo
parkinsoniano	pessoa que tem a Doença de Parkinson
parkinsonismo	síndrome, conjunto de sintomas, em que ocorrem tremores e lentidão de movimentos semelhantes à Doença de Parkinson (DP). Não é o mesmo que DP.
paroxística	a pesquisar
patogênese	a pesquisar
patógeno	organismos como bactérias, vírus, fungos etc. que causam doenças se conseguirem entrar no corpo do hospedeiro (pessoa, animal); o mesmo que agente patogênico
patogenia	o que causa a doença
patologia	área da medicina que estuda as doenças e o que elas causam nos organismos; o mesmo que doença
patológico	relacionado a doença
patologista	médico que diagnostica doenças examinando tecidos e células com um microscópio; também realiza autópsias (*defifnição de autópsia)
pedículo cerebelar superior	a pesquisar
pelve	osso da bacia
perfusão	a pesquisar
pericardial	ao redor do coração
periodicidade	a pesquisar
períodos off	a pesquisar
periósteo	a pesquisar
períneo	
peristaltismo	a pesquisar
peritônio	camada que envolve a parte de dentro do abdômen
perna agitar	a pesquisar
pesticida	a pesquisar
pilates	conjunto de exercícios físicos, ministrados por proffional habiltado,  feitos de acordo com o método inventado por Joseph Pilates em 1920
pink1	a pesquisar
piridoxina	vitamina B-6, atua no sistema nervoso para produzir hormônios importantes, encontrada em miúdos, carnes, castanhas e soja.
placebo	a pesquisar
plaquetária	a pesquisar
plaqueta	a pesquisar
plasma	a pesquisar
plasmócito	a pesquisar
plasticidade	a pesquisar
pleura	estrutura que fica ao redor do pulmão
pleura visceral	a pesquisar
pneumologia	a pesquisar
pneumologista	a pesquisar
pneumonia	a pesquisar
polidipsia	sensação de muita sede (sintoma da diabetes)
polineurite	a pesquisar
pólipo	a pesquisar
polissintomática	a pesquisar
poliúria	a pesquisar
porção reticular	a pesquisar
portador	pessoa que tem alguma doença, condição ou necessidade especial. Em vez de "portador [da Doença] de Parkinson", use "pessoa com Parkinson"
pós operatório	a pesquisar
potência de gama	a pesquisar
pramipexol	a pesquisar
praxia	
prejuízo funcional	a pesquisar
pré mórbido	a pesquisar
presbiopia	problema de visão (olhos) causado pelo envelhecimento (piora com a idade)
prescrição	receita
pressão sanguínea	pressão feita pelo sangue contra as paredes dos vasos; pressão do sangue
procedimento estereotáxico	procedimento de exame em que um aro é fixado em torno da cabeça do paciente para que o médico possa, com a ajuda de um exame de imagem, direcionar, com precisão, um instrumento até um ponto exato dentro do cérebro da pessoa.
prognóstico	avaliação, feita pelo médico, com base em dados científicos, sobre como uma doença ou um tratamento poderá se desenvolver para uma pessoa.
pronação	a pesquisar
prontuário médico	a pesquisar
propriocepção	a pesquisar
propulsão	a pesquisar
prosódia	a pesquisar
prosopagnosia	incapacidade de reconhecer rostos conhecidos, como de amigos 
próstata	a pesquisar
proteico	a pesquisar
proteína	a pesquisar
proteína g	a pesquisar
protocolo clínico	a pesquisar
protrusão	descolamento de um órgão para a frente
proximal	mais próximo ao membro
prurir	coceira
psicogênico	a pesquisar
psicologia	a pesquisar
psicólogo	a pesquisar
psicose	a pesquisar
psicossomático	a pesquisar
psicoterapeuta	a pesquisar
psicoterapêutico	a pesquisar
psicoterápico	a pesquisar
psicotrópico	a pesquisar
psiquiatra	a pesquisar
psiquiatria	a pesquisar
psns	a pesquisar
púbis	a pesquisar
pulmões	a pesquisar
pulmonar	relacionado aos pulmões
pulsátil	a pesquisar
punção	a pesquisar
pupilo	a pesquisar
pupilo dilatar	a pesquisar
purgativo	laxante forte
purina	componentes presentes no nosso organismo e em alimentos como carne vermelha, frutos do mar, peixes, certos grãos como ervilha, lentilha e feijão, em bebidas alcoólicas, principalmente cerveja
pústula	a pesquisar
putâmen	a pesquisar
quadríceps	músculo da coxa
queimação	a pesquisar
queloide	a pesquisar
quimioluminescência	a pesquisar
quimioterapia	a pesquisar
radiofrequência	a pesquisar
radiografia	a pesquisar
radioterapia	a pesquisar
raio x	imagem dos ossos
raio x	imagem dos ossos
rasagilina	a pesquisar
rash	a pesquisar
reabilitação	a pesquisar
reação alérgica	a pesquisar
reações adverso	a pesquisar
receptor adrenérgico	a pesquisar
receptor colinérgico	a pesquisar
receptor dopaminérgico	a pesquisar
receptor pós sináptico	a pesquisar
redundância	capacidade de mais de uma área do cérebro de realizar a mesma função
reflexo de estiramento	a pesquisar
reflexo de flexão	a pesquisar
reflexo de flexão	a pesquisar
reflexo de retirada	a pesquisar
reflexo miotático	a pesquisar
reflexo	reação automática (sem pensar) do corpo
refluxo	a pesquisar
refluxo gastroesofágico	a pesquisar
regurgitação	retorno de sólidos ou fluidos para a boca vindos do estômago
remissão	a pesquisar
reserpina	a pesquisar
respiração diafragmática	a pesquisar
resposta imunológica	a pesquisar
ressonância	a pesquisar
ressonância magnética	exame de imagem de alta definição usado para detectar vários tipos de doenças 
retardo mental	condição, geralmente irreversível, caracterizada por uma capacidade intelectual inferior à normal com dificuldades de aprendizado e de adaptação social, que normalmente está presente desde o nascimento ou que se manifesta nos primeiros anos da infância
retenção fecal	a pesquisar
retenção urinária	a pesquisar
retrocolo	a pesquisar
retropulsão	tendência de cair para trás
retrovírus	um tipo de vírus, o HIV é um exemplo de retrovírus
ribossomos	estruturas responsáveis pela síntese (produção) de proteínas nas células
rigidez	endurecimento; duro
rigidez muscular	quando os músculos ficam rígidos/duros
rinite	inflamação da parte de dentro do nariz, que causa coceira, olhos lacrimejantes, espirros etc. 
rim	funcionam como um sistema de filtragem do nosso corpo, elimitando substâncias tóxicas
ritmo circadiano	a pesquisar
rna	a pesquisar
ropinirol	a pesquisar
rotigotina	a pesquisar
saturação	a pesquisar
seborreia	produção exagerada de sebo ou de gordura na pele ou couro cabeludo
secreção	a pesquisar
secretar	a pesquisar
sedação	técnica na qual o médico aplica um medicamento que faz com que o paciente durma e não sinta dor durante procedimentos médicos
sedar	anestesiado
sedar	anestesiar
sedativo	que anestesia
sedentário	pessoa que passa muito tempo inativa, isto é, sem fazer exercícios físicos
sedentarismo	situação em que a pessoa não pratica qualquer tipo de atividade física regularmente, além de permanecer muito tempo sentada e não ter disposição para realizar atividades simples do dia a dia, o que tem influência direta na saúde e bem-estar da pessoa
selegilina	remédio para Doença de Parkinson
semiologia	a pesquisar
semiológico	a pesquisar
sequenciamento de exoma	exame que identifica doenças genéticas (doenças transmitidas dos pais para os filhos)
sequenciamento de dna	a pesquisar
sepse	inflamação em todo o corpo
sépsis	inflamação em todo o corpo
serotonina	hormônio que  regula o humor, sono, apetite, ritmo do coração, temperatura do corpo, sensibilidade e pensamento;  em baixa quantidade,  pode causar mau humor, dificuldade para dormir, ansiedade ou até depressão
sialorreia	saliva que escorre da boca (babar)
sinal vital	a pesquisar
sinal de babinski	a pesquisar
sinapse	a pesquisar
sinapse colinérgica	a pesquisar
sincinesia	a pesquisar
síncope	desmaio
síndrome de shy drager	a pesquisar
síndrome extrapiramidal	a pesquisar
síndrome parkisoniana	o mesmo que parksinsonismo, conjunto de sintomas semelhantes à Doença de Parkinson; um conjunto de sintomas caracteriza uma síndrome e não corresponde a uma doença específica.
sinemet	medicamento para Doença de Parkinson
sintetização	produção; agrupamento
sintetizar	produzir; agrupar
sintoma	sinais que confirmam doenças
sintoma autonômico	intolerância ao calor, suor excessivo, constipação intestinal, entre outros
sintoma neurovegetativo	náuseas, vômitos, palidez
sintomático	que apresenta sintomas; sinais de uma condição ou doença
sintomatologia	sintomas ou sinais de uma condição ou de uma doença
sinucleína	a pesquisar
siringomesencefalia	a pesquisar
sistema cardiovascular	a pesquisar
sistema digestivo	órgãos que trabalham juntos para transformar os alimentos que comemos em combustível para que o nosso corpo funcione; são eles:  boca, faringe, esôfago, estômago, intestino delgado, intestino grosso, reto, fígado e pâncreas
sistema digestório	órgãos que trabalham juntos para transformar os alimentos que comemos em combustível para que o nosso corpo funcione; são eles:  boca, faringe, esôfago, estômago, intestino delgado, intestino grosso, reto, fígado e pâncreas
sistema endócrino	sistema que mantém o equilíbrio químico do corpo, trabalha em conjunto com o sistema nervoso para regular os outros sistemas. Isso é feito enviando mensageiros chamados hormônios através do corpo via corrente sanguínea.
sistema esquelético	a pesquisar
sistema excretor	a pesquisar
sistema extrapiramidal	a pesquisar
sistema imune	defende o nosso corpo contra infecções e outras doenças; ele é formado por vários órgãos, células e proteínas chamadas anticorpos. O sistema imune identifica, ataca e destrói germes e outras sustâncias que tentam atacar o nosso corpo.
sistema imunológico	defende o nosso corpo contra infecções e outras doenças; ele é formado por vários órgãos, células e proteínas chamadas anticorpos. O sistema imunológico identifica, ataca e destrói germes e outras sustâncias que tentam atacar o nosso corpo
sistema límbico	responde pelos comportamentos instintivos, pelas emoções profundamentes arraigadas e pelos impulsos básicos, como sexo, ira, prazer e sobrevivência
sistema linfático	a pesquisar
sistema motor extrapiramidal	a pesquisar
sistema muscular	a pesquisar
sistema nervoso autônomo	parte do sistema nervoso que controla funções como a respiração, circulação do sangue, temperatura e digestão
sistema nervoso central	a pesquisar
sistema nervoso parassimpático	a pesquisar
sistema nervoso periférico	nervos; liga o sistema nervoso central aos outros órgãos do corpo para transportar as informações
sistema nervoso visceral	parte do sistema nervoso que controla funções como a respiração, circulação do sangue, temperatura e digestão
sistema neurovegetativo	parte do sistema nervoso que controla funções como a respiração, circulação do sangue, temperatura e digestão
sistema parassimpático	a pesquisar
sistema reprodutor	órgãos que trabalham juntos pela reprodução (geração de filhos); na mulher são a vagina, os ovários, as trompas e o útero e no homem são os testículos, o pênis, o escroto e a prostata  
sistema respiratório	formado pelo nariz, faringe, laringe, traqueia, brônquios e pulmões, nesta ordem
sistema simpático	a pesquisar
sistema tegumentar	a pesquisar
sistema urinário	órgãos que trabalham em conjunto para produzir, guardar e eliminar a urina; esses órgãos são dois rins, dois ureteres, uma bexiga e uma uretra
sistole	a pesquisar
snc	Sistema Nervoso Central
sobrar	a pesquisar
sonambulismo	quando a pessoa anda e fala dormindo
sonho vívido	sonhos que parecem reais
sono rem	fase do sono em que a pessoa sonha
sonolência	grande vontade de dormir; sentir muito sono
subcostal	abaixo das costelas
subcutâneo	debaixo da pele
sublingual	debaixo da língua; um remédio sublingual deve ser colocado debaixo da língua até derreter
substância cinzento	responsável por interpretar os impulsos nervosos das regiões do corpo até o encéfalo, produzir impulsos e coordenar atividades musculares e reflexos; o mesmo que massa cinzenta;
substância negro	porção do cérebro que é responsável pela produção de dopamina (*Ver dopamina no glossário)
substância nigra	porção do cérebro que é responsável pela produção de dopamina (*Ver dopamina no glossário)
suceptibilidade genética	a pesquisar
sudorese	suor ou transpiração
sujeito controlo	a pesquisar
suplementação	que completa
sutura	quando o médico ou dentista "costura" a pele, os músculos músculos, vasos sanguíneos e outros tecidos do corpo humano, após uma lesão; dar pontos
tálamo	a pesquisar
talamotomia	a pesquisar
taquicardia	disparos da batida do coração
taquifemia	a pesquisar
taquilalia	a pesquisar
tarefa motor fino	a pesquisar
taxa de letalidade	representa o risco que as pessoas com uma doença têm de morrer por essa mesma doença
tdh	a pesquisar
tecido adiposo	tecido de gordura
tecido conectivo	sustenta e cobre as estruturas do corpo, mantém os orgãos no lugar e conecta as partes do corpo entre si
tecido conjuntivo	sustenta e cobre as estruturas do corpo, mantém os orgãos no lugar e conecta as partes do corpo entre si
tecido epitelial	encontrado na pele e no revestimento dos vasos sanguíneos; forma a cobertura das superfícies internas e externas do corpo e o revestimento dos tratos digestivo, respiratório e urinário
tecido fibroso	a pesquisar
tecido mole	a pesquisar
tecido muscular	proporciona movimento; sua função principal é contrair-se
tecido muscular liso	apresenta uma contração lenta e involuntária, que não depende da vontade do indivíduo, e forma a musculatura dos órgãos internos, como a bexiga, estômago, intestino e vasos sanguíneos
tecido muscular estriar esquelético	apresenta uma contração rápida e voluntária, ou seja, obedece a nossa vontade, e está ligado aos ossos e atua na movimentação do corpo
tecido estriado cardíaco	a pesquisar
tecido nervoso	conduz impulsos de e para o cérebro e é composto de células nervosas chamadas de neurônios
telencéfalo	a pesquisar
tendão	tecido conectivo que une os músculos aos ossos
tendinite	inflamação nos tendões
terapêutica	que trata
terapêutica	tratamento
terapia ocupacional	área de conhecimento que beneficia pessoas de todas as idades que tenham alguma dificuldade ou incapacidade de realizar atividades do dia a dia
terapeuta ocupacional	profissional formado em curso superior que cuida do bem-estar de pessoas que tenham alguma limitação ou dificuldade para as suas atividades físicas do dia a dia
terapia protetora	a pesquisar
terapia sintomática	a pesquisar
termocoagulação	tipo de tratamento para varizes
termo de consentimento	documento em que a pessoa concorda com algo
testosterona	hormônio  sexual masculino
tetania	a pesquisar
tímpano	tipo de pele fina que fica dentro do ouvido separando a parte de dentro do ouvido da parte de fora
tique	quando a pessoa repete um movimento ou som algumas vezes ou sem parar
tireoide	localizada no pescoço, age na função de órgãos importantes como o coração, cérebro, fígado e rins, além de interferir em várias outras funções como o crescimento das crianças e adolescentes, ciclo menstrual da mulher e muito mais
tirosina	substância encontrada em carnes brancas e vermelhas e frutos do mar e que forma a dopamina. Ver dopamina no Glossário.
tolcapone	medicamento para Doença de Parkinson
tomografia	tipo de exame de diagnóstico por imagem
tomografia computadorizada	tipo de exame de diagnóstico por imagem
tônus muscular	condição dos músculos que permite a boa sustentação do corpo da pessoa, ajuda na sustentação dos órgãos dentro do corpo  e favorece a movimentação da pessoa
tônus postural	a pesquisar
topografia de córnea	exame de olhos para analisar formato e curvatura da córnea
topografia corneana	exame de olhos para analisar formato e curvatura da córnea
tórax	peito
torácico	do peito
torcicolo	torcida dolorosa do pescoço
torpor	sensação de sono
toxicologia	a pesquisar
toxina botulínica	a pesquisar
toxina	veneno, droga
tpm	tensão pré-mestrual
transdução	algo que pode ser venenoso
transecção	a pesquisar
transtorno bipolar	doença  em que a pessoa tem alterações repentinas de humor, que varia do muito animado até extremamente infeliz e deprimido
transtorno amnéstico	a pesquisar
transtorno conversivo	a pesquisar
transtorno distímico	a pesquisar
transtorno de o déficit de atenção	doença em que a pessoa não consegue concentrar a atenção nas coisas que precisa fazer
transtorno de o humor	problema de saúde mental em que a pessoa sofre com períodos prolongados de muita tristeza (depressão) ou de muita alegria ou euforia (mania), ou as duas coisas
transtorno	a pesquisar
traqueia	órgão do sistema respiratório que filtra, umedece e conduz o ar aos pulmões
traqueostomia	corte no tubo pelo qual passa o ar quando a pessoa respira
traqueotomia	corte no tubo pelo qual passa o ar quando a pessoa respira
tratamento medicamentoso	tratamento que envolve o uso de medicamentos
tratamento reabilitacional	tratamento auxiliar
tratamento adjuvante	tratamento auxiliar
tratamento cirúrgico	tratament que envolve uma cirurgia (operação) 
tratamento sintomático	a pesquisar
trato digestivo	a pesquisar
trato respiratório	a pesquisar
trato urinário	conjunto dos  órgãos (rins, ureteres, bexiga e uretra) que fazem o sistema que produz a urina funcionar
trato córtico espinal	a pesquisar
trato gastrointestinal	a pesquisar
trauma craniano	lesão (machucado) da cabeça
tremor refratário	a pesquisar
tremor	a pesquisar
tremor cinético	a pesquisar
tremor de ação	tremedeira que acontece quando a pessoa está em movimento
tremor de repouso	tremedeira que acontece quando a pessoa está parada
tremor distal	a pesquisar
tremor essencial	problema neurológico em que ocorrem tremores no corpo sem que a pessoa consiga controlar. Não é o mesmo que Doença de Parkinson
tremor postural	a pesquisar
triagem	separação, escolhas, filtragem
tricíclico	a pesquisar
trombócitos	a pesquisar
trombose	formação de um coágulo de sangue dentro do coração ou vasos
trompa de eustáquio	a pesquisar
tronco cerebral	encontra-se embaixo do cérebro, na frente do cerebelo. Ele liga o cérebro à medula espinhal e controla funções involuntárias como respiração, digestão, ritmo cardíaco e pressão arterial
tronco encefálico	parte do cérebro responsável pelas funções involuntárias (aquelas que fazemos sem perceber), como respiração, ritmo dos batimentos cardíacos e pressão arterial etc. 
tronco de o encéfalo	parte do cérebro responsável pelas funções involuntárias (aquelas que fazemos sem perceber), como respiração, ritmo dos batimentos cardíacos e pressão arterial etc. 
tuba auditivo	a pesquisar
tubo digestivo	é composto pela boca, faringe, esôfago, estômago, intestino delgado e intestino grosso
tubo digestório	é composto pela boca, faringe, esôfago, estômago, intestino delgado e intestino grosso
tumor	a pesquisar
turvação visual	dificuldade para enxergar com niditez
tutela	guarda, responsabilidade
úlcera	ferida, machucado
úlcera gástrica	ferida, machucado dentro do estômago da pessoa
úlcera péptica	ferida, machucado dentro do estômago da pessoa
ultrassom	a pesquisar
umbilical	relacionado ao umbigo
unilateral	de um lado só
ureia	susbtância que tem na urina
ureteres	tubos que levam a urina dos rins para a bexiga
urologia	parte da medicina que cuida do sistema  urinário masculino e feminino e do sistema reprodutivo masculino
urologista	médico especializado em tratar doenças do sistema urinário masculino e feminino e masculino e do sistema reprodutivo masculino
uso oral	pela boca
valor acromático	a pesquisar
valor cromático	a pesquisar
válvula mitral	a pesquisar
variação fenotipica	a pesquisar
variz	inchaço anormal das veias que ocorre normalmente nas pernas
vas	a pesquisar
vascularização	a pesquisar
vascularização cerebral	a pesquisar
vasoconstrição	a pesquisar
vasoconstritor	a pesquisar
vasodilatação	a pesquisar
vasodilatador	a pesquisar
vaso capilar	os menores vasos sanguíneos; o mesmo que capilares e capilares sanguíneos
vaso sanguíneo	a pesquisar
veia cavar	maior veia do corpo
veia	a pesquisar
veia pulmonar	a pesquisar
velocidade autosselecionadar	a pesquisar
venoso	que é das veias
ventilação	auxílio para entrada de ar
ventrículo	cavidades, espaços
ventrículo cardíaco	partes do  coração  que são como  câmaras que recebem e bombeiam sangue
ventrículo cardíaco direito	a pesquisar
ventrículo cardíaco esquerdo	a pesquisar
vértebras	ossos da coluna
vertigem	tontura, sensação de cair
vesícula	pequena bolsa localizada abaixo do fígado que armazena a bile. Ver bile no glossário.
via aferente	ver fibras sensoriais 
via eferente	a pesquisar
via nigroestriada	a pesquisar
via oral	pela boca
vídeolaparoscopia	a pesquisar
vírus	partícula basicamente proteica que pode infectar organismos vivos, causando doenças
vísceras	órgãos, tripas, intestinos
visomotor	a pesquisar
wearing off	a pesquisar
xerostomia	baixa produção de saliva, boca seca
zigoto	célula resultande da união do espermatozóide e do óvulo, fase inicial do feto