abdome 	parte do corpo situada entre o tórax e a pelve; barriga
abdômem 	parte do corpo situada entre o tórax e a pelve; barriga
abdominocentese 	punção cirúrgica no abdômem para a retirada de líquido ou pus
abdução 	movimento de afastamento dos membros do eixo do corpo; método utilizado para testar a amplitude dos movimentos dos membros inferiores ou superiores do corpo.
ablação 	técnica cirúrgica em que o médico produz uma lesão no cérebro para melhorar os sintomas da doença
abordagem multidisciplinar 	participação de vários especialistas no diagnóstico e escolha do tratamento
abscesso 	acúmulo de pus em tecidos, órgãos ou espaços dentro do corpo
acatisia 	sensação de tremor muscular, agitação e incapacidade de ficar sentado e parado
acetilcolina 	substância química que transmite os impulsos nervosos entre as células do sistema nervoso e as células musculares
acidente vascular cerebral 	derrame cerebral ou AVC
acidente vascular encefálico 	o mesmo que AVC; derrame
ácido desoxirribonucleico 	conjunto de moléculas que carrega a informação genética de todos os seres vivos (características da espécie e do indivíduo); o mesmo que DNA
ácido gama aminobutírico 	neurotransmissor que regula a agitação cerebral por meio da inibição do disparo excessivo dos neurônios, o que leva a uma sensação de calma; o mesmo que GABA
ácido úrico 	composto produzido pelo fígado, mas alimentos ricos em purina (*definição de purina) podem aumentar as concentrações de ácido úrico no organismo e causar problemas de saúde como gota, pedras nos rins, pressão alta, entre outros
acidose 	condição anormal caracterizada pela redução da alcalinidade do sangue e dos tecidos sanguíneos
acinesia 	paralisia, incapacidade de se mover ou dificuldade para iniciar ou manter os movimentos
acometer 	atingir, afetar
acometer 	aquele que sofre com os sintomas e/ou consequências de uma doença
acompanhamento clínico 	acompanhamento do paciente pelo profissional de saúde
acuidade 	capacidade de percepção dos minúsculos estímulos de um dos cinco sentidos 
acuidade mental 	capacidade de adquirir, interpretar, selecionar e organizar os dados e informações que são alcançados através dos sentidos
acuidade olfativa 	capacidade para distinguir cheiros; o mesmo que acuidade olfatória
acuidade olfatória 	capacidade para distinguir cheiros; o mesmo que acuidade olfativa
acuidade visual 	capacidade do olho para distinguir detalhes espaciais, ou seja, identificar o contorno e a forma de objetos e pessoas
acupuntura 	terapia milenar chinesa que consiste na aplicação de agulhas em pontos específicos do corpo para tratar doenças e promover saúde
adenite 	inflamação de uma glândula (*Ver glândula no glossário); íngua
adenomegalia 	aumento de uma glândula (*Ver glândula no glossário)
adenosina 	medicamento utilizado para tratar taquicardia em pacientes com problemas cardíacos, como batimentos cardíacos irregulares
adesão a o tratamento 	quando há concordância entre o comportamento do paciente e as recomendações e o tratamento indicado pelo profissional de saúde 
adh 	hormônio antidiurético existente no corpo humano que previne a perda excessiva de água
administração de medicamento 	uso de medicamentos conforme recomendação médica
administrar medicamento 	dar medicamentos ao paciente de acordo com procedimentos pré-estabelecidos
adrenalina 	substância produzida nas glândulas suprarrenais (acima dos rins) que tem a função de manter o corpo alerta
adrenoreceptores 	o mesmo que receptores adrenérgicos* (sem definição)
adstringente 	qualidade do que que causa contração ou sensação de amarramento espacielmente nas mucosas
adução 	movimento que aproxima os membros, como pernas e braços, do eixo do corpo
afagia 	incapacidade ou dificuldade de engolir
afasia 	perda parcial ou total da capacidade de expressar ou compreender a linguagem falada ou escrita
afebril 	sem febre
afonia 	perda total ou parcial da voz
afônico 	condição de estar sem voz
agente colinérgico 	composto que imita a ação da acetilcolina (*Ver acetilcolina no glossário)
agente neuroprotetor 	medicamentos/substâncias que têm a finalidade de proteger os neurônios
agente patogênico 	organismo capaz de produzir doenças infecciosas aos seus hospedeiros sempre que esteja em circunstâncias favoráveis, podem ser bactérias, vírus, fungos, entre outros, o mesmo que patógeno
ageusia 	falta ou diminuição do paladar
agnosia 	incapacidade ou dificuldade de reconhecer objetos por lesão no córtex cerebral correspondente àquela função
agnosia auditivo 	incapacidade ou dificuldade de identificar objetos por meio do som
agnosia gustativo 	incapacidade ou dififculdade para identificar alimentos pelo paladar
agnosia olfativa 	incapacidade ou dificuldade para identificar cheiros
agnosia tátil 	incapacidade ou dififculdade para identificar objetos pelo toque
agnosia visual 	incapacidade ou dificuldade para reconhecer objetos e pessoas pela visão 
agonista de o dopamina 	substância (medicamento) que ativa os receptores de dopamina, produzindo os mesmos efeitos da dopamina no corpo
agrotóxico 	agrotóxicos
ait 	ataque isquêmico transitório: deficiência repentina do suprimento de sangue para o cérebro por um curto espaço de tempo
alcalinidade 	capacidade que um sistema aquoso tem para neutralizar ácidos
alcoolismo 	doença crônica caracterizada pelo consumo compulsivo de álcool, condicionado pela dependência
alelo 	o alelo é uma variação específica do gene, que vai determinar como essa característica irá se expressar no indivíduo. Por exemplo, o gene da cor dos olhos possui muitos alelos, como alelos para a cor dos olhos azuis, castanhos ou verdes.
alexia 	perda da capacidade de identficar a linguagem escrita
alfa sinucleina 	proteína que mais se acumula no cérebro da pessoa com DP, destruindo células importantes
alimento protéico 	alimentos ricos em proteína
alopecia 	perda de cabelo
alta hospitalar 	documento emitido por um hospital que consta que o paciente pode retornar para a sua casa
alterações bioquímica 	alterações químicas do corpo
alucinações 	percepção de ter visto, ouvido, tocado, provado ou cheirado algo que não existe
alzheimer 	doença degenerativa e progressiva que se manifesta apresentando deterioração cognitiva e da memória de curto prazo e uma variedade de sintomas neuropsiquiátricos e de alterações comportamentais que se agravam ao longo do tempo
amantadina 	medicamento que libera dopamina no interior do cérebro utilizado para tratar a lentidão e a rigidez dos músculos
amaurose 	cegueira total
ambliopia 	baixa visão em um ou nos dois olhos que não é corrigida com óculos; também chamado de olho preguiçoso
amígdala 	localizada no lobo temporal (*Ver lobo temporal no glossário), faz parte do chamado cérebro profundo, parte do cérebro responsável pelas emoções básicas e o instinto de sobrevivência, além das nossas lembranças emocionais
amimia 	perda da capacidade de fazer gestos ou sinais para representar ideias e sentimentos
aminar 	moléculas orgânicas fundamentais na formação de proteínas; existem dezenas de tipos de aminoácidos, alguns são produzidos pelo nosso corpo e outros podem ser ingeridos pela alimentação; os aminoácidos são importantes na regeneração celular (ex.: pele), muscular, entre outras funções
amnésia 	perda total ou parcial da memória, incapacidade de lembrar eventos, perda permanente ou temporária da memória
ams 	Atrofia Multissistêmica (*Ver Atrofia Multissistêmica no glossário)
amusia 	dificuldade para compreender sons musicais por lesão do córtex cerebral correspondente àquela função.
anabólico 	relativo ao anabolismo (*Ver anabolismo no glossário)
anabolismo 	fase do metabolismo em que acontece a sintetização das moléculas, o que resulta na formação de moléculas mais complexas a partir de outras mais simples
analgesia 	técnica que utiliza medicamentos com o objetivo de aliviar ou minimizar a dor, sem que o paciente fique inconsciente
anamnese 	entrevista realizada pelo profissional de saúde com o paciente com o objetivo de ser um ponto inicial no diagnóstico de uma doença
anatomia 	descrição dos elementos que constituem o corpo
anatomopatologia 	especialidade médica que estuda o diagnóstico das doenças baseado nos aspectos dos tecidos dos órgãos e das células 
ancilose 	rigidez em uma articulação
anemia 	condição na qual o conteúdo da hemoglobina (*Ver hemoglobina no glossário) no sangue está abaixo do normal, podendo causar fadiga, palidez, falta de ar, vertigem, tonturas ou batimento cardíaco acelerado
anemia falciforme 	doença hereditária caracterizada pela alteração dos glóbulos vermelhos do sangue, tornando-os parecidos com uma foice, daí o nome falciforme. Essas células têm sua membrana alterada e rompem-se mais facilmente, causando anemia
anestesia 	técnica utilizada em procedimentos cirúrgicos e outros procedimentos na qual o médico aplica um anestésico para que o paciente não sinta dor; dependendo do tipo de anestesia o paciente pode ficar consciente ou inconsciente
anestesia geral 	técnica utilizada em procedimentos cirúrgicos na qual o médico aplica anestésicos e o paciente fica inconsciente e não sente dor
anestesia local 	são aplicadas pequenas doses de anestésico apenas no local da lesão ou da intervenção
anestesia peridural 	tipo de anestesia que bloqueia a dor e as sensações de apenas uma região do corpo, geralmente da cintura para baixo; neste tipo de anestesia a pessoa pode se manter acordada
anestesia raquidiano 	tipo de anestesia que bloqueia a dor e as sensações de apenas uma região do corpo, geralmente da cintura para baixo; neste tipo de anestesia a pessoa pode se manter acordada
anestésico 	medicamento que reduz ou tira a sensibilidade, minimizando a dor
anestesiologia 	especialidade médica que estuda e proporciona ausência ou alívio da dor e outras sensações ao paciente que necessita realizar procedimentos médicos, como cirurgias ou exames diagnósticos, identificando e tratando eventuais alterações das funções vitais
anestesiologista 	médico que administra um anestésico; médico especializado em anestesia e que monitora as funções vitais do paciente durante um procedimento cirúrgico ou de diagnóstico
anestesista 	médico que administra um anestésico; médico especializado em anestesia e que monitora as funções vitais do paciente durante um procedimento cirúrgico ou de diagnóstico
aneurisma 	dilatação anormal da parede de uma artéria, que pode acabar se rompendo e provocando uma hemorragia ou um AVC
aneurisma cerebral 	dilatação anormal num dos vasos sanguíneos que levam sangue até ao cérebro
aneurisma de o aorta 	dilatação anormal de alguma parte da aorta, a maior artéria do corpo
anfetamina 	droga sintética que estimula a atividade do sistema nervoso central, podendo provocar excitação, insônia e falta de apetite 
angina 	tipo de dor no peito causada pela redução do fluxo sanguíneo para o coração
anomalia 	aquilo que não é normal
anomalia congênita 	alterações estruturais ou funcionais do desenvolvimento fetal, cuja origem ocorre antes do nascimento
anorexia 	distúrbio alimentar caracterizado pela visão distorcida do próprio corpo, peso abaixo do normal, receio de ganhar peso, vontade intensa de ser magro e restrições alimentares
anormalidade 	aquilo que não é normal
anosmia 	ausência de olfato
anosognosia 	falta de consciência sobre a sua própria doença
anoxia 	ausência de oxigênio
anoxia cerebral 	falta de oxigênio no cérebro
anquilose 	rigidez de uma articulação
ansiolítico 	grupo de medicamentos usado para diminuir a ansiedade e a tensão
antiálgica 	que protege contra a dor
antibacteriano 	substância que destrói as bactérias ou evita o seu desenvolvimento
antibiótico 	grupo de medicamentos utilizado para tratar infecções causadas por bactérias
anticoagulante 	medicamentos que retardam o processo de coagulação, impedindo a formação de coágulos no sangue
anticolinérgico 	grupo de medicamentos que ajuda da reduzir os tremores 
anticonvulsivante 	classe de medicamentos utilizada para a prevenção e tratamento das crises convulsivas e epilépticas, neuralgias (dores nos nervos) e também no tratamento de transtornos de humor, como bipolaridade; o mesmo que anticonvulsivo
anticolvulsivo 	classe de medicamentos utilizada para a prevenção e tratamento das crises convulsivas e epilépticas, neuralgias (dores nos nervos) e também no tratamento de transtornos de humor, como bipolaridade; o mesmo que anticonvulsivante
anticorpo 	proteínas que atuam no sistema imunológico como defensores do organismo contra bactérias, vírus e outros corpos estranhos
antidepressivo 	grupos de medicamentos usado para tratar depressão e outros transtornos, como ansiedade, disturbios alimentares etc.
antiemético 	medicamentos que evitam o vômito
anti inflamatório 	agente (substância ou medicamento) que combate as inflamações
antimicrobiano 	substâncias naturais que agem sobre micro-organismos inibindo o seu crescimento ou causando a sua destruição
anti retroviral 	medicamentos usados para o tratamento de infecções por retrovírus, principalmente o HIV
antirretroviral 	medicamentos usados para o tratamento de infecções por retrovírus, principalmente o HIV
antioxidante 	composto ou substância química que inibe a oxidação (danos às células)
antiparkisonianos 	grupo de medicamentos utilizados para tratar os sintomas da Doença de Parkinson e de outras doenças que causam tremores
antipsicótico 	grupo de remédios usado para tratar algumas doenças da mente (psicoses), como esquizofrenia, entre outras; podem ajudar também no controle das emoções, como agressividade, impusividade, instabilidade do humor
antisséptico 	impede a proliferação de micróbios
anúria 	diminuição ou ausência de produção de urina
aorta 	a maior e mais importante artéria do corpo, que recebe sangue oxigenado do coração e é responsável por enviá-lo ao restante do corpo
aparelho digestivo 	formado por vários órgãos como a  boca, faringe, esófago, estômago, intestino delgado, intestino grosso, reto, fígado e pâncreas, é  boca, faringe, esófago, estômago, intestino delgado, intestino grosso, reto, fígado e pâncreas, é responsável por obter dos alimentos ingeridos os nutrientes necessários às diferentes funções do organismo, como crescimento, energia para reprodução, locomoção etc.
aparelho digestório 	formado por vários órgãos como a  boca, faringe, esófago, estômago, intestino delgado, intestino grosso, reto, fígado e pâncreas, é  boca, faringe, esófago, estômago, intestino delgado, intestino grosso, reto, fígado e pâncreas, é responsável por obter dos alimentos ingeridos os nutrientes necessários às diferentes funções do organismo, como crescimento, energia para reprodução, locomoção, etc
aparelho reprodutivo 	órgãos que trabalham em conjunto pela reprodução; na mulher são a vagina, os ovários, as trompas e o útero e no homem são os testículos, o pênis, o escroto e a prostata  
aparelho reprodutor 	órgãos que trabalham em conjunto pela reprodução; na mulher são a vagina, os ovários, as trompas e o útero e no homem são os testículos, o pênis, o escroto e a prostata  
aparelho urinário 	órgãos que trabalham em conjunto para a produção, depósito e eliminação da urina, sendo eles dois rins, dois ureteres, uma bexiga e uma uretra
aparelho vestibular 	estruturas localizadas na orelha interna responsáveis pela manutenção do equilíbrio
apatia 	falta de interesse, emoção ou preocupação
apneia 	suspensão voluntária ou involuntária da respiração
apneia de o sono 	distúrbio do sono em que a respiração para e volta diversas vezes; o meso que apneia noturna
apneia noturna 	distúrbio do sono em que a respiração para e volta diversas vezes; o meso que apneia do sono
apraxia 	incapacidade de executar tarefas com movimentos conhecidos , apesar de capacidade física e desejo, 
área de broca 	região do cébrebro responsável pela expressão da linguagem
área de wernicke 	uma das áreas do córtex cerebral ligada à fala
arreflexia 	ausência de reflexo nos tendões
arritmia 	alteração na geração ou condução do estímulo elétrico do coração, pode provocar mudança do ritmo cardíaco; palpitação
arteterapia 	terapia conduzida por psicólogos que usa a arte como parte do tratamento
artéria 	vasos que geralmente transportam sangue oxigenado do coração para o resto do corpo
artérias coronària 	artérias responsáveis pela irrigação do miocárdio (músculo do coração)
artéria pulmonar 	artéria que leva o sangue do coração para os pulmões; a única artéria do corpo que carrega sangue com pouco oxigênio
articulação 	junta(s)
artralgia 	dor na articulação
artrite reumatóide 	doença inflamatória crônica que afeta muitas articulações, incluindo as das mãos e dos pés
asfixia 	alguma obstrução no caminho do oxigênio; dificuldade ou impossibilidade de respirar
asma 	doença pulmonar inflamatória crônica (de longa duração), caracterizada pelo fechamento reversível dos brônquios; como consequência, o paciente apresenta chiado, falta de ar, tosse seca e aperto no peito
aspiração	limpar secreção do nariz, garganta ou pulmão com aparelho especial; respiração
aspirar 	quando o que se engole vai para o pulmão; respirar
assintomático 	sem sintomas
astereognosia 	dificuldade de reconhecer objetos pelo tato
ataque isquêmico transitório 	deficiência repentina do suprimento de sangue para o cérebro por um curto espaço de tempo; o mesmo que AIT
ataxia 	transtorno neurológico que causa falta de equilíbrio e coordenação motora
ateroma 	placa de gordura
aterosclerose 	acúmulo de placas de gordura, cálcio e outras substâncias nas artérias, causando seu enrijecimento
atetose 	transtorno que causa movimentos involuntários anormais como torções e contorções, principalmente braços e mãos
ativação muscular 	uso dos músculos
atonia 	ausência completa de tônus muscular (*Ver tônus muscular no glossário)
atrofia 	falta de desenvolvimento, diminuição de tamanho ou peso de corpo, órgão, tecido ou membro
atrofia de múltiplos sistemas 	doença progressiva e fatal que causa danos a partes do cérebro que controlam os movimentos e muitos processos internos do corpo, como controle da bexiga, pressão arterial etc
atrofia multissistêmica 	doença progressiva e fatal que causa danos a partes do cérebro que controlam os movimentos e muitos processos internos do corpo, como controle da bexiga, pressão arterial etc
atrofiar 	que apresenta atrofia; que não conseguiu se desenvolver completamente
audição 	um dos cinco sentidos; é a capacidade de ouvir e processar sons
audiologia 	ramo da ciência que estuda a audição, seu equilíbrio e distúrbios relacionados
auditivo 	relativo à audição ou ao ouvido
auricular 	relativo ao ouvido
auscultação 	ato de escutar os sons internos do corpo  para controlar o funcionamento de um órgão ou perceber uma anomalia, normalmente usando um estetoscópio; o mesmo que ausculta
ausculta 	ato de escutar os sons internos do corpo  para controlar o funcionamento de um órgão ou perceber uma anomalia, normalmente usando um estetoscópio; o mesmo que auscultação
autismo 	condição relacionada ao desenvolvimento do cérebro em que a pessoa apresenta desapego quase total da realidade, porque o sujeito refugia-se no seu eu profundo e recusa qualquer contato com as coisas e os seres exteriores a ele mesmo
autópsia 	exame feito em cadáver para determinar a causa e o modo da morte e avaliar doenças 
avaliação clínica 	avaliação que o profissional de saúde faz da condição do paciente pelos sinais e sintomas
avc 	Acidente Vascular Cerebral (derrame cerebral)
avds 	atividades de vida diária
azia 	sensação de queimação causada por refluxo ou retorno do ácido do estômago para o esôfago
azilect 	medicamento que trata os sintomas iniciais da Doença de Parkinson
baço 	pequeno órgão localizado na parte superior esquerda do abdômen que filtra o sangue e remove os glóbulos vermelhos lesionados e produz e armazena células brancas para o sistema imune
bactéria 	organismo unicelular e microscópico associado a doenças e à decomposição de matéria orgânica; as bactérias, contudo, são muito importantes para os seres humanos e desempenham várias funções no nosso organismo, como a proteção do intestino
bactérias intestinal 	conjunto de microrganismos que vivem em nosso intestino grosso; quando estão em harmonia ajudam no metabolismo e nas defesas do corpo, quando se desequilibram podem causar doenças
balismo 	movimentos de arremesso dos membros, amplos, fortes e incessantes, normalmente só de um lado do corpo (hemibalismo)
barreira hematoencefálica 	camada fina de células que separa o sistema nervoso central da corrente sanguínea 
benigno 	que não causa dano/mal
betabloqueadores 	medicamentos que bloqueiam a ação de um hormônio chamado epinefrina nos receptores beta
bexiga 	órgão que armazena urina antes de ser eliminada do corpo
bexiga hiperativa 	problema com o funcionamento da bexiga que provoca a necessidade súbita de urinar
bile 	líquido amarelo esverdeado pegajoso e espesso produzido pelo fígado que auxilia na digestão de gorduras do intestino
biomarcadores 	indicadores (proteínas, genes e outras moléculas) que ajudam a identificar quais tratamentos funcionam melhor para cada tipo de doença e para cada paciente
biópsia 	procedimento cirúrgico no qual se colhe uma amostra de tecidos ou células para estudo em laboratório; exame frequentemente usado para diagnosticar tumores benignos ou malignos 
biotina 	vitamina antioxidante, conhecida como vitamina B-7
bipolaridade 	distúrbio associado a alterações de humor que vão da depressão a episódios de mania (excitação extrema)
blefarite 	inflamação da pálpebra que afeta os cílios ou a produção de lágrimas
blefaroespasmo 	contração ou fechamento involuntário da pálpebra 
borramento visual 	visão embaçada
bradicardia 	diminuição da frequência cardíaca
bradicinesia 	diminuição e lentidão dos movimentos
bradifrenia 	lentidão no processo cognitivo
bromocriptina 	medicamento usado no tratamento da Doença de Parkinson e outras doenças
brônquios 	estruturas tubulares flexíveis que ligam a traqueia aos pulmões e encaminham ar a esses órgãos
bruxismo 	aperto ou ranger de dentes durante o sono
bucolingual 	referente à boca e à língua
bulbo 	parte inferior do tronco cerebral que liga e estabelece a comunicação entre o cérebro e a medula espinhal; o mesmo que bulbo raquidiano e medula oblonga
bulbo raquidiano 	parte inferior do tronco cerebral que liga e estabelece a comunicação entre o cérebro e a medula espinhal; o mesmo que bulbo e medula oblonga
butirofenonas 	medicamentos utilizados para tratar vários distúrbios psiquiátricos 
cabergolina 	medicamento que produz os mesmos efeitos da dopamina no cérebro 
cãimbra de o escritor 	contração involuntária dos músculos da mão
cãimbra de o escrivão 	contração involuntária dos músculos da mão
cãimbra 	contração dolorosa e involuntária de um músculo
calázio 	massa pequena e dura na pálpebra devido ao aumento da glândula sebácea
calcificação 	acúmulo de sais de cálcio nos tecidos do corpo, tornando-os enrijecidos e espessos, entre outros problemas
cálcio 	mineral essencial para o corpo humano que atua no fortalecimento e manutenção dos ossos
cálculo 	pequenas pedras que podem aparecer, por exemplo, nos rins
cálculo biliar 	pedras na vesícula (órgão em forma de bolsa localizado abaixo do fígado que armazena a bile). Ver bile no glossário
cálculo renal 	pedras nos rins
caloria 	medida de energia usada para medir tanto o consumo dietético quanto a atividade física
caloso 	duro como um calo
caminhada nórdica 	tipo de caminhada em que a pessoa segura um bastão em cada mão para se apoiar um pouco
cancerígeno 	que pode causar câncer
capilar 	os menores vasos sanguíneos; o mesmo que vasos capilares e capilares sanguíneos
capilar sanguíneo 	os menores vasos sanguíneos; o mesmo que capilares e vasos sanguíneos
casa de repouso	abrigo ou instituição para pessoas idosas, com atendimento de profissionais de saúde
carbidopa 	medicamento usado no tratamento da Doença de Parkinson e outras doenças para aliviar os efeitos colaterais da Levodopa
carcinoma 	tipo de câncer mais comum, pode surgir em praticamente todos os tecidos do corpo
cardíaco 	relativo ou que pertence ao coração
cardiologia 	especialidade médica que se ocupa do diagnóstico e tratamento das doenças que acometem o coração
cardiologista 	médico que estuda e trata as doenças do coração
cardiomegalia 	aumento do coração
cardiopatia 	termo genérico usado para doenças do coração
cardiopatia congênita 	defeitos cardíacos presentes desde o nascimento
cardiovascular 	relativo ao coração e aos vasos sanguíneos 
cartilagem 	tecido conjuntivo com consistência mais firme mas flexível, não tão rígido quanto o tecido ósseo, que tem a função de sustentar e proteger partes do corpo, facilitar os movimentos e amortecer o impacto e o atrito entre os ossos
casa de repouso	abrigo ou instituição para pessoas idosas, com atendimento de profissionais de saúde
casa geriátrica	abrigo ou instituição para pessoas idosas, com atendimento de profissionais de saúde
catabólico 	relativo ao catabolismo. Ver catabolismo no glossário.
catabolismo 	fase do metabolismo em que moléculas complexas são transformadas em moléculas menores, fornecendo energia ao organismo
catarata 	doença caracterizada pela perda de transparência do cristalino, que é uma lente natural do olho cuja função é propiciar o foco da visão em diferentes distâncias; a catarata pode causar cegueira
catatonia 	geralmente sintoma de transtornos do humor graves ou de doenças neurológicas caracterizada pela incapacidade de se mover, falar ou interair normalmente
catecolamina 	*sem definição
catar 	tubo usado para injeção ou retirada de fluidos; pode ser externo ou totalmente implantado sob a pele
cavidade 	espaços dentro do corpo que contêm os órgãos internos; as cavidades ajudam a proteger, isolar e sustentar os órgãos internos
cavidade abdominal 	espaço dentro do corpo em que estão os diversoss órgãos do aparelho digestivo (estômago, intestinos, fígado, vesícula, pâncreas), baço, rins e parte dos ureteres
cavidade craniano 	espaço que contém o cérebro
cavidade pélvica 	formada pela bexiga, uretra, parte dos ureteres, útero e vagina (na mulher), parte do intestino grosso e o reto
cavidade pleural 	fica ao redor dos pulmões
cavidade torácica 	espaço dentro do tórax que compreende o esôfago, a traqueia, os pulmões e o coração
cefaleia 	dor de cabeça
célula 	menores unidades funcionais de qualquer ser vivo; existem organismos unicelulares (uma única célula), como as bactérias, e pluricelulares (com muits células), como o ser humano
células estaminal não embrionária 	células presentes em muitos tecidos do organismo adulto
células nervoso 	células do sistema nervoso central que transmitem informações para todo o corpo
células piramidal 	um tipo de neurônio em forma de triângulo encontrado em partes do cérebro e responsável pela execução dos movimentos voluntários
células tronco 	células que dão origem a todos os tecidos e órgãos do nosso corpo; elas têm uma capacidade única de se renovar e de se diferenciar em outras células, podendo reparar tecidos que foram danificados por doenças, acidentes ou envelhecimento natural
centro de massa 	local em que o peso do corpo fica concentrado
cerebelo 	região do cérebro envolvida no equilíbrio e coordenação dos movimentos
cérebro 	principal órgão e centro do sistema nervoso que controla todo o corpo, todas as ações voluntária e involuntários do nosso corpo
cerúleo 	estrutura do cérebro responsável pela resposta ao estresse e fundamental no funcionamento do sono
cicatriz 	marca deixada por uma lesão curada
cifose 	desvio ou curvatura anormal da coluna
cinestesia 	capacidade de perceber a posição e o movimento de uma parte do corpo (propriocepção consciente).
cintilografia 	tipo de exame de diagnóstico por imagem
cintilografia óssea 	exame que detecta tumores e pontos de inflamação nos ossos causados por infecções, artrite, fratura, alterações na circulação sanguínea do osso, avalia próteses ósseas etc.
cirurgia bilateral 	cirurgia nos dois lados do corpo, por exemplo, nas duas mamas, nos dois lados do cérebro
cirurgia unilateral 	cirurgia só de um lado do corpo, por exemplo, mama esquerda, lado direito do cérebro
cisto 	espécie de bolsa de tecido, que pode ser cheia de ar, líquido, pus ou outro fluido, que podem se formar dentro de qualquer tecido do corpo
citologia 	estudo da estrutura e funções das células
citologista 	especialista que estuda as células
clínica especializar 	local onde vários médicos e outros profissionais de saúde trabalham
clonazepam 	medicamento que promove a inibição leve das funções do sistema nervoso central, sendo usado para tratar crises epilépticas e transtornos de ansiedade e de humor
clorose	tipo de anemia
coagulação 	processo que envolve uma série de fatores e garante que a pessoa não perca muito sangue; o sangue deixa de ser líquido e se transforma em uma massa quase sólida, o coágulo
coágulo 	estruturas que se formam naturalmente no corpo como uma forma de bloquear feridas e impedir a perda de sangue; contudo, os coágulos nem sempre são positivos e quando se formam dentro de uma artéria ou veia podem interromper o fluxo fundamental do sangue e causar sofrimento a órgãos e tecidos 
coágulo sanguíneo 	estruturas que se formam naturalmente no corpo como uma forma de bloquear feridas e impedir a perda de sangue; contudo, os coágulos nem sempre são positivos e quando se formam dentro de uma artéria ou veia podem interromper o fluxo fundamental do sangue e causar sofrimento a órgãos e tecidos 
cóclea 	estrutura da orelha interna responsável pela audição
coeficiente de letalidade 	proporção entre o número de mortes por uma doença e o número total de doentes que sofrem dessa doença, ao longo de um determinado período de tempo
cognição 	capacidade do ser humano de processar informações e adquirir conhecimento através de alguns processos, como percepção, atenção, associação, memória, raciocínio, juízo, imaginação, pensamento e linguagem
cognitivo 	relativo à cognição (*Ver cognição no glossário)
colesterol 	tipo de gordura encontrada em nosso organismo importante para o seu funcionamento normal; quando o nível de colesterol está muito alto ele pode ser prejudicial à saúde
colículos inferior 	região do sistema nervoso central que recebe informações visuais
colículos superior 	região do sistema nervoso central que recebe informações auditivas
cólon 	parte central do intestino grosso que tem como função reabsorver a água do alimento digerido para sua posterior eliminação pelas fezes
colostomia 	cirurgia que produz uma abertura no cólon (*Ver cólon no glossário), formando um novo trajeto e local para a saída das fezes
coluna vertebral 	eixo central do corpo que sustenta nossa posição bípede; eixo de comunicação entre o sistema nervoso central e periférico,via medula espinhal; espinha dorsal
coma 	estado de inconsciência no qual uma pessoa não pode ser despertada
coma induzido 	coma (*Ver coma no glossário) temporário provocado por uma dose controlada de medicamentos; é usado para proteger o cérebro durante grandes neurocirurgias
coma irreversível 	coma (*Ver coma no glossário) no qual não há reação a estímulos, nenhum movimento espontâneo e não há registro de atividade no cérebro
comorbidade 	existência de duas ou mais doenças em um mesmo organismo, sendo que uma doença potencializa a outra
comprimento de o passar 	distância de dois passos
comprometimento cognitivo 	comprometimento das funções como atenção, memória, linguagem e raciocínio
compulsão 	impulso irresistível de agir, mesmo que a razão diga para não fazer. Exemplos: comer demais, beber demais, jogatina.
concussão 	disfunção temporária depois de um ferimento; é como se fosse um machucado no cérebro que melhora normalmente depois de 24 horas
condição basal 	quantidade mínima de energia que corpo da pessoa em repouso precisa para se manter vivo
confusão mental 	incapacidade de pensar com clareza
congelamento de o marcha 	parada súbita da execução do movimento da caminhada
congênito 	que vem desde o nascimento
congestão nasal 	nariz entupido
constipação 	intestino preso, dificuldade de evacuar
constritivo 	que aperta, que (se) contrai; o mesmo que constritor
constritor 	que aperta, que (se) contrai; o mesmo que constritivo
contraindicação 	a ser evitado, não recomendado
contrair 	a ser evitado, não recomendado
contratura 	ocorre quando o músculo se contrai de maneira involuntária e incorreta e não volta ao seu estado normal de relaxamento
controlo motor 	controle dos movimentos
convulsão 	movimentacão sem controle causada por uma atividade elétrica anormal do cérebro; há muitas causas diferentes para a convulsão; em uma crise convulsiva, a pessoa fica rígida, pode cair no chão e começa a se debater
coordenação motor 	capacidade do nosso corpo de realizar e controlar os movimentos
coprolalia 	tendência incontrolável de proferir palavras obscenas e fazer comentários não aceitos socialmente
corda vocal 	pregas vocais; dobras de tecido musculoso dentro da laringe (*Ver laringe no glossário) que vibram quando atravessadas pelo ar, produzindo o som da voz
coreia 	movimentos involuntários e rápidos que começam em uma parte do corpo e passam para outra, assemelhando-se a uma dança
coriza 	secreção das fossas nasais; nariz escorrendo
córnea 	tecido transparente, fino e resistente localizado na parte anterior do olho; ela permite a entrada da luz e executa dois terços das tarefas de foco
corpo caloso 	estrutura do cérebro que conecta os hemisférios direito e esquerdo; é importante na organização das informações que chegam aos hemisférios cerebrais
corpo estriar 	parte central do cérebro com neurônios importantes; é uma das partes mais afetadas por doenças neurológicas como Doença de Parkinson e Alzheimer
corpo de lewy 	agrupamento anormal de proteínas dentro de células nervosas
córtex 	parte externa do cérebro, que todos chamam de "massa cinzenta", por causa de sua coloração acinzentada; é responsável pela nossa capacidade de pensamento, movimento voluntário, linguagem, julgamento e percepção
córtex cerebral 	parte externa do cérebro, que todos chamam de "massa cinzenta", por causa de sua coloração acinzentada; é responsável pela nossa capacidade de pensamento, movimento voluntário, linguagem, julgamento e percepção
córtex motor primário 	responsável pela produção de movimentos corporais voluntários; as áreas de associação ajudam a planejar e executar atividades motoras complexas
córtex visual 	parte do cérebro responsável pelos processos de percepção e reconhecimento visual; diretamente ligado ao nosso sentido da visão; o mesmo que córtex visual
cortisol 	hormônio produzido pelas glândulas suprarreinas (Ver no glossário) e diretamente envolvido na resposta ao estresse
covid	doença contagiosa provocada pelo coronavírus SARS-CoV-2, causa desde infecções sem sintomas até problemas respiratórios muito graves, podendo matar
covid-19	doença contagiosa provocada pelo coronavírus SARS-CoV-2, causa desde infecções sem sintomas até problemas respiratórios muito graves, podendo matar
craniano 	referente ao crânio
crânio 	caixa óssea que protege o cérebro de danos externos
creatina 	substância orgânica (aminoácido) que ajuda a fornecer energia para as células musculares
crise epilética 	descarga elétrica entre os neurônios mais duradoura que o normal, podendo causar convulsão
crise epiléptica 	descarga elétrica entre os neurônios mais duradoura que o normal, podendo causar convulsão
crise oculogírica 	crise que provoca movimentos anormais no globo ocular
cristalino 	lente natural do olho responsável pelo foco da visão em diferentes distâncias
crônico	sem cura
cromossomos 	estruturas que contêm os genes (que carregam as informações genéticas de um ser vivo); nos seres humanos, cada célula contém 23 pares de cromossomos, incluindo os dois cromossomos responsáveis pelas características sexuais (XX na mulher e XY no homem)
cuidado paliativo 	abordagem interdisciplinar de assistência médica com o objetivo de otimizar a qualidade de vida e mitigar o sofrimento de pessoas com doenças graves e complexas ou sem cura
cuidador 	pessoa responsável por cuidar do paciente; pode ter vínculo familiar ou não, podendo ser um profissional contratado para tal função
cutâneo	 da pele
dbs 	do inglês "Deep Brain Estimulation"; o mesmo que Estimulação Cerebral Profunda (*Ver Estimulação Cerebral Profunda no glossário)
dançaterapia 	terapia que utiliza os movimentos corporais da dança como forma de tratamento
declínio cognitivo 	perda de funções como atenção, memória, linguagem e raciocínio
decúbito 	posição da pessoa que está deitada
decúbito dorsal 	deitado de barriga para cima
decúbito lateral 	deitado do lado esquerdo com a coxa e o joelho direitos junto ao peito
decúbito ventral 	deitado de barriga para baixo
deficiência intelectual 	atraso no desenvolvimento cognitivo de algumas pessoas que pode ser percebido por dificuldade de aprendizado, pouca interação com outras pessoas e incapacidade de realizar atividades simples
degeneração estriadonitral 	doença degenerativa dos neurônios (perda de neurônios)
degeneração estriatonigral 	doença degenerativa dos neurônios (perda de neurônios)
degeneração estrionígrica 	doença degenerativa dos neurônios (perda de neurônios)
degeneração nigroestriatal 	doença degenerativa dos neurônios (perda de neurônios)
degeneração 	mudança(s) para um estado pior
deglutição 	ação de engolir
deglutir 	engolir
delírio 	ideia ou pensamento que não corresponde à realidade
delirium 	ideia ou pensamento que não corresponde à realidade
demência 	perda de capacidades do cérebro, como capacidade intelectual, memória, raciocínio 
demência de corpos de lewy 	doença que causa a perda progressiva da função mental
demência senil 	perda de capacidade do cérebro pela velhice
demenciar 	processo de perda de capacidades do cérebro
densidade óssea 	quantidade de cálcio (grau de mineralização) que um osso tem
densitometria óssea 	exame que determina a densidade dos ossos da pessoa, importante no diagnóstico da osteoporose
depleção 	perda ou diminuição de substância presente no organismo, como sangue, água, sódio etc.
depressão 	doença que causa tristeza e desânimo constante, entre outros sintomas
dermatite atópica 	inflamação na pele caracterizado por lesões avermelhadas, que coçam muito e, às vezes, descamam; geralmente, elas se localizam na face das crianças pequenas e nas dobras do joelho e cotovelo das crianças maiores e dos adultos.
dermatite seborreico 	inflamação na pele que causa manchas vermelha e descamação, principalmente no couro cabeludo e em partes da face
derrame pleural 	conhecido como água no pulmão, é o acúmulo de líquidos dentro da pleura, membrana que reveste e protege o pulmão
desautonomia	quando o sistema nervoso autônomo (*Ver sistema nervoso autônomo) não funciona bem, afetando o coração, a bexiga, os intestinos, as glândulas de suor, as pupilas (olhos) e os vasos sanguíneos
desfibrilação 	dar choques elétricos no paciente, através de um desfibrilador (equipamento eletrônico) para reverter um quadro de fibrilação - ritmo fora do normal do coração
desfibrilador 	aparelho eletrônico médico usado para reverter um quadro de fibrilação - quando o ritmo do coração fica fora do normal
desidratação 	condição que pode ser grave, caracterizada por baixa concentração não só de água, mas também de sais minerais e líquidos no corpo, a ponto de impedir que o organismo realize suas funções normais
desidratar 	pessoa com baixa concentração de água, sais minerais e líquidos orgânicos no organismo
desmopressina 	medicamento que reduz a produção de urina
desnutrição 	falta de nutrientes suficientes no corpo causada por má alimentação ou doença
desordem neurológica 	doença que atinge o sistema nervoso central
desorientação 	estado de confusão em relação ao tempo, espaço e/ou identidade
desorientação temporoespacial 	confusão em relação ao tempo e ao espaço
desorientação temporo espacial 	confusão em relação ao tempo e ao espaço
diabetes 	doença causada pela produção insuficiente ou má absorção de insulina, que é o hormônio que regula a glicose (açúcar) no sangue; um alto índice de glicose no sangue pode causar danos aos órgãos, vasos sanguíneos e nervos
diabetes mellitu 	doença causada pela produção insuficiente ou má absorção de insulina, que é o hormônio que regula a glicose (açúcar) no sangue; um alto índice de glicose no sangue pode causar danos aos órgãos, vasos sanguíneos e nervos
diafragmar 	músculo que separa o tórax do abdomém e que ajuda nos movimentos da respiração
diagnóstico 	definição do tipo de doença
diagnóstico clínico 	definição de uma doença pelos sinais e sintomas
diagnóstico diferencial 	definição do tipo de doença feito por exclusão, processo de eliminação de outras doenças
diagnóstico histopatológico 	definição da doença através da análise dos tecidos e células
diagnóstico precoce 	é uma forma de prevenção e visa a identificar a doença em estágios iniciais
diálise 	tratamento que substitui a função dos rins
diástole 	período de relaxamento muscular ou recuperação do músculo cardíaco; período em que o coração está relaxado, e alterna com o período de contração muscular
diencéfalo 	*sem definição
dieta cetogênica 	dieta com alto consumo de gordura, proteína moderada e baixo carboidrato 
digestão 	processo de transformação física e química que faz com que os nutrientes dos alimentos que comemos cheguem até as células para nutrir o nosso corpo
digestivo 	relativo à digestão ou ao sistema digestivo (*Ver digestão / sistema digestivo no glossário)
digestório 	relativo à digestão ou ao sistema digestivo (*Ver digestão / sistema digestivo no glossário)
diplopia 	visão dupla, em que os indivíduos veem duas imagens no objeto
disartria 	fraqueza nos músculos usados na fala, o que pode deixar a fala arrastada ou lenta
disautonomia 	condição em que o sistema nervoso autônomo (SNA) não funciona corretamente, podendo afetar o funcionamento do coração, da bexiga, dos intestinos, das glândulas sudoríparas, das pupilas e dos vasos sanguíneos
discinesia 	distúrbio em que a pessoa faz movimentos amplos e involuntários
discrasia 	condição anormal ou patológica do sangue
disdiadococinesia 	dificuldade de fazer movimentos rápidos em sequência
disfagia 	dificuldade na deglutição
disfasia 	dificuldade para falar ou usar as palavras corretamente
disfemia 	distúrbio de fala envolvendo problemas frequentes com a fluência e o fluxo normais da fala; gagueira
disfluência 	distúrbio da fala no qual o fluxo normal da fala é prejudicado, como na gagueira
disfonia 	dificuldade para emitir sons, voz alterada ou fraca
disforia 	estado de desconforto, tristeza ou mal-estar
disfunção 	distúrbio, funcionamento anormal
disfunção erétil 	incapacidade de o homem conseguir obter e manter uma ereção do pênis suficiente que possibilite uma atividade sexual
disfunção miccional 	termo genérico para se referir a problemas de função da bexiga urinária, que incluem dificuldades no armazenamento ou esvaziamento da urina
disfunção olfativa 	capacidade reduzida para sentir cheiros
disfunção sexual 	dificuldade sentida por uma pessoa ou casal durante qualquer estágio da atividade sexual, incluindo desejo, excitação ou orgasmo
disfunção visual 	problemas de visão
disfunção autonômica 	condição em que o sistema nervoso autônomo (SNA) não funciona corretamente, podendo afetar o funcionamento do coração, da bexiga, dos intestinos, das glândulas sudoríparas, das pupilas e dos vasos sanguíneos
dislipidemia 	aumento da taxa de gordura no sangue
dismetria 	execução defeituosa de movimentos que visam atingir um alvo, pois o indivíduo não consegue dosar exatamente o movimento
disosmia 	diminuição do olfato
dispareunia 	dor genital persistente ou recorrente que surge pouco antes, durante ou após a relação sexual
dispepsia 	sensação de dor ou desconforto na parte superior do abdomên, queimação, causada por dificuldade na digestão
displasia 	ocorrência de anomalias relacionadas ao desenvolvimento de um órgão ou tecido; indica a presença de alterações nas características das células, que podem sofrer modificações de forma, tamanho, organização e função
dispneia 	respiração difícil ou dolorosa; dificuldade na respiração
disprosódia 	alteração no ritmo da fala; o mesmo que disrimolalia
disritmolalia 	alteração no ritmo da fala; o mesmo que disprosódia
dissecação 	ato de separar em partes; abertura e/ou separação de organismos mortos para estudo
distal 	afastado do tronco
distensão muscular 	rompimento de um músculo ou de tecido muscular que liga o músculo ao osso
distonia 	contrações musculares involuntárias que causam movimentos repetitivos ou de torção
distônica 	relativo à distonia (*Ver distonia no glossário) 
distrofia 	desenvolvimento anormal
distrofia muscular 	grupo de doenças genéticas que causa fraqueza progressiva e perda de massa muscular
distúrbio 	funcionamento anormal de um órgão ou sistema do corpo
distúrbio comportamental de o sono rem 	problema com pesadelos nos quais a pessoa grita, chora, dá socos ou pontapés. Pode ser um problema anterior ao desenvolvimento da doença de Parkinson
distúrbio não motor 	distúrbios não relacionados ao movimento, que podem incluir depressão, demência etc
distúrbio de movimento 	doenças que causam problemas nos movimentos; dificuldades para se movimentar
distúrbio de o sono 	dificuldades para pegar no sono ou durante o sono
distúrbio autonômico 	quando o sistema nervoso autônomo (*Ver sistema nervoso autônomo no glossário) não funciona bem, afetando o coração, a bexiga, os intestinos, as glândulas de suor, as pupilas (olhos) e os vasos sanguíneos
distúrbios cerebelar 	funcionamentos anormais relacionados ao cerebelo (*Ver cerebelo no glossário)
distúrbios neurocomportamental 	problemas de comportamento da pessoa associados a problemas neurológicos que ela tenha
distúrbio neuropsiquiátrico 	problemas de comportamento da pessoa associados a problemas neurológicos que ela tenha
distúrbio psiquiátrico 	condições que afetam o humor, o raciocínio e o comportamento
distúrbio vestibular 	tontura e desequilíbrio
distúrbios visual 	problemas na visão como escurecimento da visão, distorções de imagem etc.
diurese 	aumento de excreção de urina
diurético 	medicamentos utilizados para aumentar o volume urinário, atuando na redução do líquido presente no corpo, bem como reduzindo a pressão arterial
dna 	conjunto de moléculas que carrega a informação genética de todos os seres vivos (características da espécie e do indivíduo)
doença autoimune 	doença em que o sistema imunológico do corpo ataca células saudáveis
doença autossômica dominante 	tipos de doenças que aparecem em todas as gerações de uma família e apenas um gene do pai ou da mãe é necessário para que a doença seja transmitida
doença autossômica recessivo 	tipos de doenças que precisam de dois genes ou mais com defeito, do pai e da mãe, para que a doença seja transmitida para o filho(a)
doença crônica 	doença sem cura e que exige que a pessoa faça uso contínuo de medicação
doença crônico neurodegenerativa 	doença que causa a perda progressiva da saúde dos neurônios do cérebro
doença de alzheimer 	doença progressiva que destrói a memória e outras funções mentais importantes
doença de corpos de lewy 	doença que causa a perda progressiva da função mental
doença de parkinson 	doença que ataca o sistema nervoso, ainda não tem cura. Não passa de pessoa para pessoa. A pessoa com Parkinson vai perdendo a capacidade de controlar seus movimentos. Os principais sintomas são: tremor nas mãos ou braços, lentidão, dificuldade para manter o equilíbrio, levantar e caminhar.
doença congênita 	doença cuja origem ocorre antes do nascimento
doença neurodegenerativa e crônica 	doença que causa a perda progressiva da saúde dos neurônios do cérebro
doença bucal 	doença que afeta a boca
doença degenerativo 	tipo de doença em que a condição da pessoa vai piorando aos poucos
doença extrapiramidal 	doença que ocorrem em uma parte do cérebro que controla os movimentos
doença genética 	doença hereditária causada por uma anormalidade no DNA
doença hereditária 	doença transmitida de geração em geração
dopamina 	substância que atua como uma mensageira entre as partes do cérebro e o sistema nervoso, ajudando no controle e na coordenação dos movimentos, entre outras funções
dopaminérgico 	relacionado à dopamina (hormônio muito importante naturalmente produzido no cérebro que ajuda a realizar uma série de funções, como controlar os movimentos, sentir cheiros, lembrar das coisas etc.)
dopler 	exame que usa ultrassom para determinar a velocidade do fluxo de sangue dentro dos vasos
dor aguda 	dor forte que surge repentinamente e tem sua duração limitada; normalmente quando a causa é descoberta a dor pode ser controlada ou eliminada
dor crônica 	dor persistente que dura de semanas a anos
dor fulgurante 	dor rápida e intensa
dor lancinante 	dor em golpes, aguda e forte
dor radicular 	originada por lesão ou irritação em um ou mais nervos e suas raízes nervosas que passam pela coluna vertebral
dosagem 	dose do medicamento; a quantidade de medicamento capaz de provocar uma resposta terapêutica desejada no paciente
dosagem prescrito 	a quantidade de medicamento recomendada pelo médico para que o tratamento surta efeito
dp 	forma abreviada de Doença de Parkinson (*Ver Doença de Parkinson no glossário)
dpoc 	Doença Pulmonar Obstrutiva Crônica: grupo de doenças pulmonares que bloqueiam o fluxo de ar e dificultam a respiração
droga 	medicamento
droga sintética 	substâncias ou mistura de substâncias produzidas através de meios químicos
duloxetina 	antidepressivo; medicamento que trata depressão e outros distúrbios psiquiátricos
duodeno 	parte inicial e mais curta do intestino delgado e sua principal função é receber os alimentos parcialmente digeridos do estômago e continuar o processo digestivo
ecocardiograma 	exame de ultrassonografia do coração que fornece imagens obtidas através do som
ecolalia 	repetição mecânica e sem parar de palavras ou frases 
ecp 	Estimulação Cerebral Profunda: cirurgia mais utilizada para combater os sintomas de doenças neurológicas, como tremores
eczema 	inflamação na pele
edema 	inchaço causado por excesso de líquido retido nos tecidos do corpo
edema periférico 	inchaço nas extremidades
edêntulo 	sem dentes
efeito "wearing off " 	redução do efeito do medicamento
efeito neuroprotetor 	mecanismos e estratégias usados para proteger os neurônios contra danos decorrentes de enfermidades que afetam o Sistema Nervoso Central
efeito colateral 	efeito diferente do pretendido de um medicamento
efeito adverso 	quaisquer efeitos indesejados de um medicamento
ecg 	eletrocardiograma; exame feito com um aparelho ligado a eletrodos que avalia o ritmo dos batimentos cardíacos em repouso
ecmo 	máquina que substitui o coração e o pulmão em pacientes graves
egg 	eletroencefalograma; exame utilizado para registrar a atividade elétrica do cérebro e detectar doenças
eletrocardiograma 	exame feito com um aparelho ligado a eletrodos que avalia o ritmo dos batimentos cardíacos em repouso, o mesmo que ECG
eletrodar 	peça metálica constituída por 4 contatos elétricos na sua ponta que é implantada no alvo cerebral escolhido
eletroencefalograma 	exame utilizado para registrar a atividade elétrica do cérebro e detectar doenças; o mesmo que EGG
eletromiografia 	exame que grava da atividade elétrica de um músculo; o mesmo que EMG
embolia 	obstrução de um vaso ou artéria por um coágulo levado pela corrente sanguínea
embolia arterial 	obstrução de um vaso ou artéria por um coágulo levado pela corrente sanguínea
embolia cerebral 	ocorre quando um coágulo de sangue viaja até o cérebro, causando um AVC (derrame) ou um AIT (*Ver no glossário)
embolia pulmonar 	quando artérias (vasos) do pulmão ficam bloqueadas por coágulos de sangue (formas sólidas do sangue)
êmese 	vômito 
emg 	eletromiografia; exame que grava a atividade elétrica de um músculo
encefálico 	relativo ao encéfalo (*Ver encéfalo no glossário)
encefalite 	inflamação do cérebro
encefalite letárgica 	também conhecida como doença europeia do sono, que causa  letargia, sonolência incontrolável e tremores
encéfalo 	centro do sistema nervoso responsável pelo processamento e integração das informações do nosso corpo; não é o mesmo que cérebro, pois o encéfalo engloba outras partes do sistema nervoso
encefalopatia 	termo usado para qualquer doença cerebral que altera o funcionamento ou a estrutura do cérebro
encefalopatia de o pugilista 	doença cerebral causada por trauma na cabeça
endemia 	presença contínua de uma doença ou de um agente infeccioso em uma zona geográfica determinada
endocárdio 	revestimento interno do coração
endocrinologia 	especialidade médica que cuida do funcionamento das glândulase e das doenças que as afetam, como problemas de crescimento, diabetes, obesidade, osteoporose, entre outras
endocrinologista 	médico que cuida das doenças relacionadas às glándulas e aos hormônios produzidos e secretados por elas
endógeno 	que se origina no interior do organismo
endoscopia 	exame nos órgãos do sistema digestivo para avaliar doenças como refluxo, gastrite e câncer
endoscópio 	aparelho usado para exame visual interno
endovenoso 	injeção por agulha o catéter dentro das veias; o mesmo que intravenoso
enfarte 	ocorre quando o fluxo de sangue deixa de chegar ao miocárdio (músculo cardíaco), fazendo com que esse músculo seja danificado ou morra; ataque do coração 
enfarto 	ocorre quando o fluxo de sangue deixa de chegar ao miocárdio (músculo cardíaco), fazendo com que esse músculo seja danificado ou morra; ataque do coração 
enfarto de o miocárdio 	ocorre quando o fluxo de sangue deixa de chegar ao miocárdio (músculo cardíaco), fazendo com que esse músculo seja danificado ou morra; ataque do coração 
enfermidade 	doença
enfermo 	doente
entacapona 	tipo de medicamento utilizado no tratamento da Doença de Parkinson
entubar 	colocar tubo ou sonda no paciente
extubar 	remover tubo ou sonda do paciente
enurese 	perda de controle da bexiga, variando de uma ligeira perda de urina após espirrar, tossir ou rir até a total incapacidade de controlar a micção
enxaqueca 	dor de cabeça de intensidade variável, muitas vezes acompanhada de náuseas e sensibilidade à luz e ao som; também conhecida como hemialgia
enzima 	proteína que acelera reações químicas no corpo. As enzimas são muito importantes para manter as atividades celulares saudáveis. Alterações nas enzimas podem ter um papel importante na Doença de Parkinson. 
epidemia 	doença de caráter transitório, que ataca simultaneamente grande número de indivíduos em uma determinada localidade
epidemiologia 	estudo de padrões, causas e controle da doença em grupos de pessoas.
epiderme 	camada externa da pele
epilepsia 	distúrbio cerebral crônico de diferentes origens caracterizado por crises epilépticas recorrentes e espontâneas
epinefrina 	hormônio produzido pelo nosso corpo e remédio com efeitos em diferentes sistemas do corpo; quando remédio pode ser usado em situações de emergência como crises de alergia grave e em muitas outras situações 
episódio 	um único acontecimento importante em uma série de eventos, como um período crítico no curso de uma doença
equimose 	mancha avermelhada ou escura formada na pele por sangue extravasado em consequência de contusão
ereto 	posição de pé
eritema 	tipo de vermelhidão da pele
eritema multiforme 	inflamação na pele caracterizada por placas vermelhas e salientes em todo o corpo
eritema nodoso 	inflamação da camada de gordura abaixo da pele que provoca caroços (nódulos) vermelhos ou roxos 
eritrócito 	hemácias ou glóbulos verbelhos, são células sanguíneas que exercem importante papel na oxigenação dos tecidos, responsáveis pela cor vermelha do sangue
eritromelalgia 	síndrome rara em que pequenas artérias (vasos) da pele se dilatam, provocando dor semelhante a queimação, sensação de pele quente e vermelhidão
escala de apgar 	numeração que expressa a condição de uma criança recém-nascida a um minuto do nascimento e novamente depois de cinco minutos
escala de ashworth 	escala mais utilizada na avaliação e mensuração da espasticidade (tônus muscular aumentado). Varia de 0 a 4
escala de lawton 	mede a capacidade dos idosos de realizarem atividades mais complexas que as atividades básicas da vida diária; o mesmo que índice de Lawton
esclerose 	degeneração dos tecidos, que pode ocorrer em vários órgãos e estruturas do corpo, como nervos, pulmões etc.
esclerose hipocampal 	atrofia de uma parte do cérebro chamada hipocampo (*Ver hipocampo no glossário)
esclerose de o hipocampo 	atrofia de uma parte do cérebro chamada hipocampo (*Ver hipocampo no glossário)
esclerose mesial 	*sem definição
esclerose múltipla 	doença autoimune que afeta o cérebro, os nervos ópticos e a medula espinhal (sistema nervoso central); o sistema imunológico do corpo confunde células saudáveis com células "intrusas", e as ataca provocando lesões.
escoliose 	curvatura lateral anormal da coluna
escorar de apgar 	numeração que expressa a condição de uma criança recém-nascida a um minuto do nascimento e novamente depois de cinco minutos
escotoma 	perda total ou parcial da capacidade de visão de uma região do campo visual, que geralmente se encontra rodeado por uma área onde a visão está preservada; ponto cego
esfignomanômetro 	aparelho usado para para medir a pressão arterial
esfíncter 	estrutura, normalmente um músculo, que ajuda a controlar orifícios no nosso corpo. Abre ou fecha orifícios.
esofagite 	inflamação do esôfago que pode provocar dor e dificuldade para engolir
esôfago 	canal que conduz o alimento até o estômago
espasmo 	contração involuntária de um músculo
espasmódico 	que causa ou que tem espamos (*definição de espasmo)
espasticidade 	estado anormal do músculo envolvendo hipertonia (aumento do tônus) e hiperrreflexia (aumento dos reflexos)
esperança de vida a o nascer 	média de anos que um grupo de indivíduos nascidos no mesmo ano irá viver, se mantidas as mesmas condições desde o seu nascimento; o mesmo que expectativa de vida
espinha dorsal 	eixo central do corpo responsável por sustentar a nossa posição bípede; além disso, é um importante eixo de comunicação entre o sistema nervoso central e periférico, através da medula espinhal; o mesmo que espinha dorsal
esplenomegalia 	aumento do baço
estabilidade dinâmica 	equilíbrio ao se movimentar
estabilidade estática 	equilíbrio ao ficar parado
estadiamento 	avaliação da extensão do tumor no paciente
estereognosia 	capacidade de perceber com as mãos a forma e o tamanho de um objeto
estereotaxia 	cirurgia pouco invasiva que usa um sistema de coordenadas tridimensional para localizar pequenos alvos no interior do corpo e para executar nestes alguma atividade, como estimulação, lesão, injeção, implante etc.
estereotipia 	ação repetitiva e ritualística no movimento, postura ou fala
esteroides 	tipo de hormônio que controla várias funções do nosso corpo, como as características sexuais de uma pessoa e o controle metabólico
estetoscópio 	instrumento para auxiliar a escuta de ruídos internos do organismo
estimulação cerebral profunda 	leva estímulos elétricos a regiões específicas do cérebro; cirurgia mais utilizada para combater sintomas de doenças neurológicas, como tremores
estimulação colinérgica 	estimulação dos nerurônios colinérgicos (*Ver neurônios colinérgicos no glossário)
estimulação dopaminérgica 	estímulo para que o cérebro libere mais dopamina (*Ver dopamina no glossário)
estimulação magnética transcraniana 	*sem definição
estimulação magneto térmica 	nova técnica minimamente invasiva utilizada para ativar pequenos grupos de células no cérebro
estimulação talâmica 	estímulo dos neurônios da região do tálamo (*Ver tálamo no glossário)
estímulo dopaminérgico 	estímulo para que o cérebro libere mais dopamina (*Ver dopamina no glossário)
estiramento 	rompimento de um músculo ou de tecido muscular que liga o músculo ao osso
estômago 	órgão presente no tubo digestivo onde os alimentos são pré-digeridos e esterilizados, a fim de seguirem para o intestino, onde são absorvidos.
estomatite aftoso 	aftas na boca
estrabismo 	desvio anormal do olho; vesguice
estresse 	resposta do organismo (física ou mental) a um evento de esforço extremo ou importante, geralmente quando a pessoa se sente ameaçada ou sob pressão
estresse oxidativo 	quando a membrana celular (*definição de membrana celular) se rompe, liberando substâncias tóxicas no organismo
estressores primário 	a pesquisar
estressores secundário 	a pesquisar
estriar 	parte central do cérebro com neurônios importantes; é uma das partes mais afetadas por doenças neurológicas como Doença de Parkinson e Alzheimer
estrogênio 	hormônios cuja ação está relacionada com o controle da ovulação e com o desenvolvimento de características femininas
estudo randomizados 	estudos nos quais os grupos estudados são divididos randomicamente/aleatoriamente
estupor 	falta de resposta em que a pessoa somente pode ser despertada com estímulo físico vigoroso
etiologia 	estudo que busca as causas, por exemplo, de uma doença
etopropazina 	tipo de medicamento utilizado no tratamento da Doença de Parkinson e outras doenças
eupneia 	respiração normal
eutanásia 	ato intencional de proporcionar a alguém uma morte indolor para aliviar o sofrimento causado por uma doença incurável
evento adverso 	qualquer ocorrência médica desfavorável ao paciente e que não tem relação causal com o tratamento
evidência clínica 	sinais e sintomas que confirmam doenças
exame ocular 	exame realizado nos olhos para avaliar a visão do paciente
exame oftalmológico 	exame que avalia os olhos, as pálpebras e os canais lacrimais de forma a investigar doenças oculares, como o glaucoma ou a catarata, por exemplo
exame audiológico 	exames que medem a audição
exame laboratorial 	exames feitos em laboratório
exame histopatológico 	exame microscópico do tecido para diagnóstico de câncer; este exame também serve para diagnosticar outras patologias, como tuberculose, micoses, infecções etc
exame neuroimagiológico 	exame de imagem do sistema nervoso
excitotoxicidade 	quando as células nervosas são super estimuladas por impulsos nervosos, causando danos ou a morte das células
exérese 	remoção por cirurgia
exoma 	exame que identifica doenças genéticas
éxons 	regiões dos genes que codificam proteínas
espectativa de vida 	média de anos que um grupo de indivíduos nascidos no mesmo ano irá viver, se mantidas as mesmas condições desde o seu nascimento; o mesmo que expectativa de vida
eupnéica 	respiração normal
expectorante 	que ou o que facilita a saída de secreções por via respiratória (diz-se de substância, medicamento etc.).
expectorar 	liberar secreções
expiração 	processo de soltar o ar
expirar 	soltar o ar
exposição crônica 	quando a pessoa é exposta a algo ou substância por muito tempo
extremidade 	mãos, pés e orelhas
fabulação 	substituir a realidade por uma aventura imaginária
fácies de máscara 	fisionomia inexpressiva, mímica facial diminuída; olhar parado, vago e fixo
fácies parkisoniana 	sintoma de doenças como Parkinson entre outras, fisionomia inexpressiva, mímica facial diminuída; olhar parado, vago e fixo
fadiga 	cansaço, exaustão
faringe 	tem a função de fazer a passagem do ar inalado e dos alimentos ingeridos até os outros órgãos dos sistemas respiratório e digestório
fármaco 	medicamento
farmacologia 	ciência que estuda como os medicamentos ou substâncias interagem com o organismo, sendo capazes de promover alterações funcionais e estruturais
farmacológico 	relativo à farmacologia (*Ver farmacologia no glossário)
farmacoterapia 	tratamento de pacientes com uso de medicamentos
fáscia 	faixa de tecido que circunda o músculo
fator ambiental 	fatores que podem contribuir para uma doença e que provêm do ambiente onde o indivíduo está inserido, como doenças causadas pela falta de saneamento básico
fator de risco 	qualquer situação que aumente a probabilidade de ocorrência de uma doença ou agravo à saúde
fator genético 	fatores que contribuem para o surgimento de uma doença e que foram passados pelos genes dos pais para seus filhos
fator predisponente 	fatores que criam as condições para o surgimento de uma doença. Os fatores predisponentes, ou seja, que contribuem para a pessoa ter pressão alta são estar acima do peso, estresse, fumar e não fazer exercícios
fda 	do inglês Food and Drug Administration: órgão governamental dos Estados Unidos responsável pelo controle de alimentos (tanto humano como animal), suplementos alimentares, medicamentos (humano e animal), cosméticos, equipamentos médicos, materiais biológicos e produtos derivados do sangue humano 
febril 	com febre
fêmur 	osso longo da coxa; maior osso do corpo humano
fenótipo 	características observáveis de um ser determinadas pela genética e pelo meio ambiente, ex.: cor do cabelo, tom da pele etc.
festinação 	aceleração não controlada dos passos para não cair para frente
fibra motor 	fibras que fazem parte dos nervos e levam os impulsos produzidos no sistema nervoso (*definição de sistema nervoso) para os órgãos onde a ação será realizada
fibra sensorial 	fibras que fazem parte dos nervos e levam as informações obtidas no meio ambiente e no interior do nosso organismo para os locais onde essas informações serão analisadas no Sistema Nervoso Central (*definição de SNC)
fibrilação 	frequência cardíaca irregular e muitas vezes acelerada que geralmente provoca má circulação sanguínea
fibromialgia 	doença que causa dor crônica e generalizada (difusa) nos músculos e em outros tecidos moles em áreas distintas
fibrose 	endurecimento maior que pode ocorrer qualquer região do corpo, geralmente na pele, gordura ou músculos
fígar 	órgão do sistema digestivo, o fígado exerce muitas funções fudamentais no nosso corpo, desde metabolizar e armazenar nutrientes até a filtragem de micro-organismos e a desintoxicação do corpo
fisiologia 	parte da biologia que estuda a atividade e as funções normais do corpo
fisiopatologia 	funcionamento da doença
fisioterapeuta 	profissional dedicado ao tratamento e à prevenção de doenças e lesões decorrentes de fraturas ou má-formação ou vícios de postura
fisioterapia 	técnicas guiadas por um profissional usadas no tratamento de problemas com os movimentos do corpo
fisioterápico 	relativo à fisioterapia (*Verfisioterapia no glossário)
fissurar 	fenda ou corte que ocorre em uma parte de um órgão
fissura anal 	pequeno corte que ocorre na borda anal e que tem como causas principais a prisão de ventre e fezes muito volumosas e endurecidas
flato 	gases; pum; peido; o mesmo que flatulência
flatulência 	gases intestinais
flora intestinal 	conjunto de microrganismos que vive em nosso intestino grosso; quando estão em harmonia ajudam no metabolismo e nas defesas do corpo, quando se desequilibram podem causar doenças; o mesmo que microbiota intestinal
fluência verbal 	facilidade para encontrar as palavras que se queira dizer ou usar
fluoxetina 	medicamento utilizado para tratar depressão e outros distúrbios mentais
flutuação motor 	problemas na coordenação motora do paciente; um dos efeitos adversos de medicamentos utilizados para tratar a Doença de Parkinson
flutuações não motor 	inclui sintomas não relacionados à coordenação motora, como distúrbios do humor, depressão, etc. e cognitivos, como falta de atenção, esquecimento, problemas de linguagem, entre outros
fonação 	traballho muscular para produzir a voz
fonoaudiologia 	ciência que estuda a fala. Conjunto técnicas guiadas por um profissional usadas para tratar problemas de fala.
fonoaudiológico 	relativo à fonoaudiologia (*Ver fonoaudiologia no glossário)
fonoterapia 	técnica que utiliza exercícios específicos para estimular a linguagem, fala, audição, motricidade oral e voz
fotofobia 	intolerância visual à luz
fotossensibilidade 	sensibilidade à luz, claridade ou ao sol.
fratura 	quebra do osso em um ou mais pedaços
fratura expor 	quando  o osso quebrado rompe os músculos e a pele
fratura óssea 	quebra do osso em um ou mais pedaços
freezing 	congelamento da caminhada, como se a pessoa estivesse colada ao chão temporariamente
frequência cardíaca 	velocidade do ciclo cardíaco medida pelo número de contrações do coração por minuto
frequência de passar 	velocidade com que se dá os passos
função hepática 	funcionamento do fígado
função metabólica 	reações químicas que acontecem nas células do nosso corpo e que transformam os alimentos em energia
funções vital 	funções necessárias para manter a vida, como nutrição (alimentação, circulação, excreção, respiração), reprodução e relação com o meio
fuso neuromuscular 	pequenas estruturas em forma de fuso situadas nos ventres dos músculos estriados esqueléticos, que controlam o tônus muscular
gaba 	neurotransmissor que regula a agitação cerebral por meio da inibição do disparo excessivo dos neurônios, o que leva a uma sensação de calma; o mesmo que GABA
gânglio 	pequenas glândulas que têm a função de defefnder o organismo, controlando infefções
gânglios de o base 	estruturas localizadas no cérebro responsáveis pelo movimento; os gânnglios da base ajudam a planejar e executar movimentos complexos; lesões nos gânglios da base podem causar rigidez, tremores e paralisia
glânglios linfático 	pequenas glândulas que têm a função de defefnder o organismo, controlando infefções; o mesmo que linfonodo
gangrena 	morte dos tecidos associada a diferentes fatores, mas principalmente à falta de irrigação sanguínea
gasto energético 	gasto de energia
gastrite 	inflamação do estômago
gastrodinia 	dor no estômago
gastropatia 	doença do estômago
gene 	segmento de uma molécula de DNA (*Ver DNA no glossário) responsável pelas características herdadas geneticamente
gene supressor 	gene que reduz a probabilidade de uma célula se tornar um tumor, pois retarda a divisão celular, repara erros do DNA ou indica quando as células devem morrer, impedindo a proliferação descontrolada das células
gênese 	origem e desenvolvimento dos seres
genética 	ciência que estuda a transmissão das características hereditárias ao longo das gerações. O que passa de pai/mãe para filho(a), hereditário.
genótipo 	composição genética elementar de um organismo; são às características internas de um indivíduo, características passadas dos pais para os filhos
gengivite 	inflamação nas gengivas
genitália 	órgãos sexuais internos e externos tanto no homem quanto na mulher
genoma 	informação genética total de uma célula ou organismo vivo; uma célula humana contém dois genomas, um materno e outro paterno
germe 	organismos microscópicos, como bactérias, fungos, vírus, parasitas etc. que podem causar doenças se entrarem no hospedeiro
geriatria	ramo da medicina que foca o estudo, a prevenção e o tratamento de doenças e da incapacidade em idades avançadas
gerontologia 	estudo dos fenômenos fisiológicos, psicológicos e sociais relacionados ao envelhecimento do ser humano
gerontológica 	relativo à Gerontologia (*Ver Gerontologia no glossário)
gh 	hormônio do crescimento (do inglês Growth Hormone)
glândula 	estruturas responsáveis pela síntese (produção) e secreção de substâncias
glândula adrenal 	estruturas que produzem e lançam no sangue substâncias reguladoras denominadas hormônios; o mesmo que glândula suprarrenal
glândula digestivo 	órgãos do corpo humano que sintetizam e liberam algumas substâncias para atuar no processo de digestão de alimentos; o fígado é um exemplo de glândula digestiva
glândula endócrina 	estruturas que produzem e lançam no sangue substâncias reguladoras denominadas hormônios
glândula hipófise 	localizada na base do crânio, é considerada a “glândula-mestre”, pois produz vários hormônios que regulam o funcionamento do nosso corpo
glândula lacrimal 	pequena estrutura em forma de amêndoa que produz lágrimas e está localizada logo acima do canto externo superior do olho
glândula salivar 	estruturas localizadas na cavidade bucal, que produzem saliva para lubrificar a boca e a garganta
glândula sebácea 	estruturas localizadas nos pelos em todas as regiões do corpo, produzem e liberam um óleo que lubrifica e protege a pele
glândula sudorípara 	glândulas sob a superfície da pele que produzem suor, grande parte delas localiza-se na fronte, nas axilas, na palma das mãos e na planta dos pés
glândula suprarrenal 	estruturas que produzem e lançam no sangue substâncias reguladoras chamadas hormônios; o mesmo que glândula adrenal
glândula tireoide 	glândula localizada na parte anterior do pescoço, é uma das maiores grândulas do corpo e age na função de órgãos importantes como o coração, cérebro, fígado e rins, além de interferir em várias outras funções como o crescimento das crianças e adolescentes, ciclo menstrual da mulher e muito mais
glaucoma 	grupo de doenças oculares que aumentam a pressão intraocular e podem causar cegueira
glicemia 	açúcar no sangue
glicose 	açúcar
glicosúria 	açúcar na urina
glioblastoma multiforme 	tumor cerebral mais comum
globo pálido 	estrutura formada por células nervosas localizada no cérebro que afeta os movimentos, equilíbrio e a caminhada.
glóbulos branco 	céulas que atuam na defesa do organismo (sistema imunológico) agindo contra infecções e outras doenças; o mesmo que leucócitos
glóbulos vermelho 	células sanguíneas que exercem importante papel na oxigenação dos tecidos, sendo também responsáveis pela cor vermelha do sangue; o mesmo que hemácias ou eritrócitos,
glossalgia 	dor na língua
gluconato de clorexidina 	substância para bochecho, usada para combater infecções
glutamato 	*sem definição
gocovri 	marca de medicamento (amantadina) utilizado no tratamento da Doença de Parkinson e outras doenças  
grupo controlo 	grupo de pessoas que, em um estudo epidemiológico ou teste clínico, não tem a doença a ser estudada ou não é submetida ao tratamento testado; esse grupo é o que toma placebo
grupo controlo 	grupo de pessoas que, em um estudo epidemiológico ou teste clínico, não tem a doença a ser estudada ou não é submetida ao tratamento testado; esse grupo é o que toma placebo
grupo de controlo 	grupo de pessoas que, em um estudo epidemiológico ou teste clínico, não tem a doença a ser estudada ou não é submetida ao tratamento testado; esse grupo é o que toma placebo
grupo de apoio de o idoso 	grupo que promove ações que visam à melhoria da qualidade de vida dos idosos
grupo de risco 	pessoas ou grupos de pessoas sujeitas a fatores (características biológicas e/ou socioculturais) que aumentam a propensão de desenvolverem determinadas doenças
halitose 	mau hálito
hemácias 	células sanguíneas que exercem importante papel na oxigenação dos tecidos, sendo também responsáveis pela cor vermelha do sangue; o mesmo que eritrócitos ou glóbulos vermelhos
hematemese 	vômito de sangue com origem no sistema gastrointestinal
hematologia 	estudo do sangue
hematológico 	referente ao sanngue
hematologista 	médico que estuda e trata das doenças do sangue
hematoma 	acúmulo de sangue em um órgão ou tecido após uma hemorragia 
hematoma subdural agudo 	acúmulo de sangue entre o cérebro e seu revestimento externo
hematúria 	sangue na urina
hemialgia 	dor principalmente na cabeça com intensidade que varia; também conhecida como enxaqueca
hemianopsia 	perda de metade do campo visual
hemibalismo 	movimentos involuntários e bruscos dos membros, de grande amplitude, apenas de um lado do corpo, podendo também ocorrer no tronco e na cabeça; a causa mais comum é o AVC; o mesmo que hemicoreia
hemicoreia 	movimentos involuntários e bruscos dos membros, de grande amplitude, apenas de um lado do corpo, podendo também ocorrer no tronco e na cabeça; a causa mais comum é o derrame; o mesmo que hemibalismo
hemicrânia paroxística 	crises de dores de cabeça primárias caracterizadas por dor aguda, estritamente unilateral, com duração de 2 a 30 minutos e que ocorrem várias vezes por dia
hemiatrofia 	atrofia de metade do corpo ou de uma parte do corpo; atrofia de metade da cara ou atrofia progressiva de metade da língua
hemiparesia 	fraqueza muscular total ou parcial em uma metade do corpo devido a lesão encefálica
hemiplegia 	paralisia de um lado do corpo
hemisfério cerebral direito 	lado direito do cérebro,  dominante para habilidades espaciais, reconhecimento de faces, visualização mental e música
hemisfério cerebral esquerdo 	lado esquerdo do cérebro, dominante para habilidades de linguagem, matemática e lógica
hemisfério direito 	lado direito do cérebro,  dominante para habilidades espaciais, reconhecimento de faces, visualização mental e música
hemisfério esquerdo 	lado esquerdo do cérebro, dominante para habilidades de linguagem, matemática e lógica
hemisférios cerebral 	lado direito e lado esquerdo do cérebro
hemodiálise 	tratamento que usa uma máquina renal artificial que filtra as toxinas do sangue
hemoglobina 	componente dos glóbulos vermelhos do sangue que tem como principal função transportar oxigênio para os tecidos.; baixos níveis de hemoglobina podem indicar anemia
hemograma 	exame que avalia as células que compôem o sangue, podendo indicar se a pessoa tem doenças como anemia, infecções ou leucemia
hemorragia 	sangramento anormal e em grande quantidade
hepatite 	inflamação do fígado causada por diferentes agentes infecciosos
hepatoesplenomegalia 	aumento do baço e do fígado
hepatotoxidade 	dano no fígado causado por substâncias químicas chamadas hepatotoxinas
hepatotoxina 	qualquer substância tóxica capaz de prejudicar o fígado
herança autossômica dominante 	a pesquisar
herança autossômica recessivo 	a pesquisar
herança genética 	propriedades dos seres vivos de transmitirem suas características aos seus descendentes
herança mendeliano 	a pesquisar
herbicida 	produto químico utilizado na agricultura para o controle de ervas daninhas
hereditariedade 	fenômeno em que os genes e as características dos pais são transmitidas aos seus descendentes
hereditariedade mendeliano 	a pesquisar
hereditário 	 que passa de pais para filhos(as)
heredodegeneração 	processo degenerativo e hereditário
hérnia 	saliência de um órgão ou parte dele através da parede que o contém; podem aparecer em diferentes regiões do corpo
hidrocefalia 	aumento anormal de líquido dentro da cavidade craniana
hidropenia 	deficiência de água no corpo (desidratação)
hiperatividade 	estado excessivo de energia, que pode ser motora (física, muscular) ou mental (intenso fluxo de pensamentos)
hipercalcemia 	condição em que o nível de cálcio no sangue é maior do que o normal
hipercinesia 	movimentos involuntários anormais, movimento excessivo ou hiperatividade
hipercinético 	relativo a movimentos anormais ou hiperatividade 
hiperêmese 	vômito excessivo
hiperestesia 	aumento da sensibilidade dos diferentes sentidos
hiperglicemia 	níveis elevados de açúcar no sangue
hiperplasia 	aumento benigno do número de células em um órgrão ou tecido
hiperplasia prostática 	próstata aumentada, o que pode causar dificuldades para urinar
hiperreflexia 	aumento dos reflexos dos músculos e tendões
hipersexualidade 	obsessão com pensamentos, impulsos ou comportamentos sexuais que podem causar sofrimento ou afetar negativamente a saúde, o trabalho ou os relacionamentos
hipertensão 	pressão arterial alta
hipertensão arterial sistêmica 	pressão arterial alta
hipertensão pulmonar 	aumento das pressões dos vasos do pulmão
hipertenso 	indivíduo com pressão alta
hipertireoidismo 	quando a glândula tireoide (*Ver glândula tireoide no glossário) produz hormônios em excesso
hipertonia 	aumento do tônus muscular
hipertropia 	aumento do tecido devido ao aumento da célula
hiperventilação 	aumento da ventilação dos pulmões além das necessidades normais do corpo
hipoatitvidade 	diminuição da atividade ou do interesse por derterminada(s) atividade(s)
hipocalcemia 	condição em que o sangue apresenta quantidade insuficiente de cálcio
hipocampo 	parte do cérebro responsável pelo aprendizado e memória; o hipocampo é importante para a formação de novas memórias
hipocinesia 	sintoma médico caracterizado por uma redução na capacidade de se movimentar
hipoestesia 	diminuição da sensibilidade dos diferentes sentidos
hipófise 	glândula localizada na base do crânio, considerada a “glândula-mestre”, pois produz vários hormônios que regulam o funcionamento do nosso corpo
hipofonia 	redução do volume da voz
hipoglicemia 	diminuição do açúcar no sangue
hipomimia 	redução ou ausência de expressões faciais e da capacidade de gesticulação
hipoquinesia 	movimento muscular lento ou reduzido
hiporreflexia 	diminuição dos reflexos dos músculos e tendões
hiposmia 	perda do olfato
hipossalivação 	falta de saliva
hipotálamo 	estrutura localizada no diencéfalo relacionada com a emoção e o comportamento
hipotensão 	pressão arterial baixa
hipotensão ortostática 	tontura ao levantar (ficar de pé) porque a pressão cai
hipotensão postural 	tontura ao levantar (ficar de pé) porque a pressão cai
hipotenso 	indivíduo com pressão baixa
hipotireoidismo 	quando a glândula tireoide produz hormônios em excesso
hipotonia 	diminuição do tônus muscular
hipoxemia 	deficiência de oxigênio contido no sangue
hipoxia 	ausência de oxigênio suficiente nos tecidos para manter as funções corporais
histerectomia 	cirurgia que remove parte ou a totalidade do útero
histerectomia abdominal 	cirurgia que remove o útero ou parte dele por meio de um corte no abdômem
histologia 	estuda o corpo microscopicamente, as estruturas minúsculas e sua composição, além das funções das células  normais, tecidos e órgãos
histológico 	relativo à histologia (*Ver histologia no glossário)
histopatologia 	estudo de como uma doença específica afeta um conjunto de células
histopatológico 	relativo à histopatologia (Ver histopatologia no glossário)
holístico 	abordagem de uma situação que busca entender os diferentes fatores a produziem, na sua totalidade e globalidade
holocraniano 	que abrange todo o crânio
homostasia 	procedimentos que têm por finalidade conter sangramentos
hormônio 	substâncias que regulam o funcionamento de diversas funções do nosso organismo
idiopático 	sem causa conhecida
implante dentário 	suportes de metal posicionados cirurgicamente no osso maxilar, abaixo da gengiva, para substituir as raízes dentárias; isso permite que o dentista monte dentes substitutos sobre eles
impotência sexual 	se refere a qualquer condição ou sintoma que prejudique a vida sexual do indivíduo
imune 	estar livre ou protegido de uma doença ou condição
imunidade 	sistema de defesa do organismo; é um conjunto de mecanismos que defendem o corpo de agentes infecciosos invasores
imunoglobulina 	proteínas que tem como principal função a defesa do organismo; o mesmo que anticorpos
imunologia 	ramo da biologia que estuda os fenômenos, a organização e o funcionamento do sistema imunológico
imunológico 	relativo à imunidade (*Ver imunidade no glossário)
imunossupressor 	 medicamentos usados para evitar a rejeição do órgão transplantado
inapetência 	falta de apetite
incapacitar 	pessoa privada de condições físicas e/ou psicológicas para realizar determinadas tarefas
incapacitante 	aquilo que incapacita; uma doença incapacitante deixa a pessoa incapaz de realizar suas atividades normais do dia a dia 
incidência 	número de casos de uma doença (ou grupo de doenças) numa população definida durante um intervalo de tempo específico
incisão 	corte geralmente realizado por um médico cirurgião com o objetivo de permitir o acesso a área a ser operada
inclusões intraneuronal 	estruturas que se formam dentro dos neurônios
incontinência de urgência 	vontade forte e repentina de urinar, ocasionada por espasmos ou contrações na bexiga e com eventuais vazamentos de urina antes de a pessoa conseguir chegar ao banheiro
incontinência fecal 	incapacidade de controlar a eliminação das fezes
incontinência urinária 	perda de controle da bexiga, variando de uma ligeira perda de urina após espirrar, tossir ou rir até a total incapacidade de controlar a micção
índice de apgar 	numeração que expressa a condição de uma criança recém-nascida a um minuto do nascimento e novamente depois de cinco minutos
índice de lawton 	mede a capacidade dos idosos de realizarem atividades mais complexas que as atividades básicas da vida diária; o mesmo que escala de Lawton
índice glicêmico 	mede o tempo que o carboidrato de um alimento demora para ser absorvido pelo intestino
infarte 	ocorre quando o fluxo de sangue deixa de chegar ao miocárdio (músculo cardíaco), fazendo com que esse músculo seja danificado ou morra; ataque do coração 
infarto 	ocorre quando o fluxo de sangue deixa de chegar ao miocárdio (músculo cardíaco), fazendo com que esse músculo seja danificado ou morra; ataque do coração 
infarto de o miocárdio 	ocorre quando o fluxo de sangue deixa de chegar ao miocárdio (músculo cardíaco), fazendo com que esse músculo seja danificado ou morra; ataque do coração 
infecção 	entrada e o desenvolvimento de um agente infeccioso (bactérias, vírus, entre outros) no organismo ou a multiplicação de um desses agentes já presente
infecção endêmica 	presença contínua de uma doença ou de um agente infeccioso em uma zona geográfica determinada
infecção urinária 	infecção causada quando bactérias presentes no nosso corpo, como entre o ânus e a vagina, migram para a bexiga, podendo chegar até os rins, causado dor e ardência para urinar; a infecção é mais leve quando fica na bexiga podendo ficar grave quando chega aos rins
infeccioso 	que causa ou que resulta de infecção
infectologia 	especialidade médica que se ocupa do estudo das doenças causadas por diversos patógenos como vírus, bactérias, protozoários, fungos e outros animais
infectologista 	médico que se ocupa do estudo das doenças causadas por diversos patógenos como vírus, bactérias, protozoários, fungos e outros animais
inflamação 	reação de defesa do organismo frente a uma agressão, que pode vir de agentes físicos (cortes, contusões, queimaduras), químicos (agentes irritantes, corrosivos etc.) e biológicos (infecções em geral causadas por vírus, bactérias etc.)
inflamatório 	que causa inflamação (*Ver inflamação no glossário)
informação tóxico farmacológica 	a pesquisar
infraumbilical 	situado abaixo do umbigo
infusão 	introduzir fluido na veia ou no tecido
inibidor 	elementos capazes de diminur ou suprimir a atividade de uma substância
insidioso	traiçoeiro, que se esconde e depois reaparece
insônia 	dificuldade para pegar no sono e/ou continuar dormindo
instabilidade postural 	dificuldade para manter a postura (tendência de cair para a frente e para trás)
insuficiência cardíaca 	quando o coração não consegue bombear a quantidade de sangue necessária para o corpo
insuficiência renal 	problema com o funcionamento dos rins
insulina 	hormônio que regula a quantidade de glicose no sangue
interação medicamentoso 	quando há uso de vários medicamentos juntos e um pode interferir sobre o outro
intercostal 	entre as costelas
internação hospitalar 	pacientes que são admitidos para ocupar um leito hospitalar por um período igual ou superior a 24 horas
intestino 	órgão em forma de tubo que se estende desde o final do estômago até ao ânus, permitindo a passagem dos alimentos digeridos, facilitando a absorção dos nutrientes e a eliminação dos resíduos
intestino delgar 	primeira porção do intestino, que liga o estômago ao intestino grosso, e a mais comprida, onde ocorre a a absorção de parte da água e da maior parte dos nutrientes
intestino grosso 	segunda porção do intestino e a menor, mas a mais importante na absorção da água, já que é aqui que mais de 60% da água é absorvida para o corpo
intraçar 	dentro da célula
intracraniano 	dentro do crânio
intramuscular 	dentro do músculo
intratável 	que não tem tratamento
intravenoso 	injeção por agulha ou catéter dentro das veias; o mesmo que endovenoso
intolerância a o lactose 	incapacidade do organismo de digerir o açúcar presente no leite, a lactose, causando sintomas como cólica, gases e diarreia, que surgem momentos após a ingestão deste alimento
intolerância a o glúten 	incapacidade ou dificuldade de digestão do glúten, que é uma proteína presente no trigo, no centeio e na cevada; nessas pessoas o glúten danifica as paredes do intestino delgado, provocando diarreia, dor e inchaço abdominal, além de dificultar a absorção de nutrientes
intolerância a o medicamento 	quando o organismo da pessoa não aceita bem o medicamento e ela passa mal, podendo apresentar vômito, diarreia e/ou dor de cabeça; em casos mais graves pode ter uma reação alérgica ao medicamento
intolerância medicamentoso 	quando o organismo da pessoa não aceita bem o medicamento e ela passa mal, podendo apresentar vômito, diarreia e/ou dor de cabeça; em casos mais graves pode ter uma reação alérgica ao medicamento
íntrons 	regiões do DNA que não codificam poteínas
intubar 	colocar tubo ou sonda no paciente; o mesmo que entubar
intubação 	procedimento em que o médico insere um tubo na traqueia para ajudar o paciente a ventilar (respirar por ventilação mecânica); o mesmo que entubação
intubação orotraqueal 	procedimento em que o médico insere um tubo na traqueia para ajudar o paciente a ventilar (respirar por ventilação mecânica); o mesmo que entubação
intubação traqueal 	procedimento em que o médico insere um tubo na traqueia para ajudar o paciente a ventilar (respirar por ventilação mecânica); o mesmo que entubação
intubação endrotraqueal 	procedimento em que o médico insere um tubo na traqueia para ajudar o paciente a ventilar (respirar por ventilação mecânica); o mesmo que entubação
ipdm 	Instabilidade Postural e Dificuldade na Marcha (desequilíbrio e dificuldade para caminhar)
íris 	parte mais visível (e colorida) do olho, e tem como função principal controlar os níveis de luz
isquemia cardíaca 	condição caracterizada pela diminuição da passagem de sangue pelas artérias coronárias, que são os vasos que levam sangue ao coração; geralmente, é causada pela presença de placas de gordura em seu interior, que quando não são devidamente tratadas, podem romper e entupir o vaso, causando dor e aumentando as chances de infarto; o mesmo que isquemia do miocárdio
isquemia cerebral 	quando há diminuição ou ausência de fluxo sanguíneo para o cérebro, diminuindo a quantidade de oxigênio que chega ao cérebro; o mesmo que AVC isquêmico
isquemia de o miocárdio 	condição caracterizada pela diminuição da passagem de sangue pelas artérias coronárias, que são os vasos que levam sangue ao coração; geralmente, é causada pela presença de placas de gordura em seu interior, que quando não são devidamente tratadas, podem romper e entupir o vaso, causando dor e aumentando as chances de infarto; o mesmo que isquemia do cardíaca
isquemia 	falta de fornecimento de sangue para um órgão ou tecido do corpo
jejum 	privação de comida ou redução das refeições diárias a uma só durante um período
janela imunológica 	período entre o contato com o agente infeccioso e o tempo que o organismo leva para produzir quantidade suficiente de anticorpos contra a infecção capazes de serem identificadas nos exames laboratoriais
joelho fletido 	joelho(s) inclinado(s)
lacrimal 	relativo à lágrima
lacrimejamento 	abundância de lágrimas nos olhos
labirinto 	estrutura da orelha interna constituída pela cóclea (responsável pela audição) e pelo vestíbulo e canais semicirculares (responsáveis pelo equilíbrio)
labirintite 	infecção ou inflamação de uma estrutura interna da orelha, o labirinto, que é responsável pela audição e pelo equilíbrio do corpo
laparotomia 	técnica cirúrgica que faz um corte no abdômem para ter acesso aos órgãos internos da região
lapso de memória 	falhas na memória; esquecimento
laringe 	órgão localizado na região da garganta, entre a traqueia e a base da língua, tem função respiratória e fonatória (produzir som)
laxante 	medicamento ou substância que estimula o movimento e a eliminação das fezes
laxativo 	medicamento ou substância que estimula o movimento e a eliminação das fezes
lesão 	ferimento, machucado
letalidade 	proporção entre o número de mortes por uma doença e o número total de doentes que sofrem dessa doença, ao longo de um determinado período de tempo
letargia 	estado de cansaço que envolve diminuição da energia, da capacidade mental e da motivação
leucemia 	tipo de câncer que afeta as células brancas do sangue, também conhecidas como leucócitos, que são as células de defesa do organismo
leucócitos 	células brancas do corpo; atuam na defesa do organismo (sistema imunológico) agindo contra infecções, doenças, alergias, resfriados; o mesmo que glóbulos brancos
leucopenia 	diminuição na contagem de glóbulos brancos (leucócitos); queda do número de células de defesa do sangue abaixo do normal
levodopa 	medicamento que aumenta a quantidade de dopamina no corpo humano. Ver dopamina no glossário.
ligamento 	tecido conectivo que liga ossos a outros ossos
linfócitos 	tipo de célula de defesa imediata do organismo, atuando contra células canceríginas e infecções virais; fazem parte dos glóbulos brancos
linfoma 	tipo de câncer que afeta os linfócitos, que são células responsáveis por proteger o corpo de infecções e doenças
linfonodo 	pequenas glândulas que têm a função de defefnder o organismo, controlando infefções; o mesmo que glânglio linfático
líquido cefalorraquidiano 	líquido que banha o cérebro e a medula espinhal; o mesmo que liquor e líquido cérebro-espinal
líquido cérebro espinal 	líquido que banha o cérebro e a medula espinhal; o mesmo que liquor e líquido cefalorraquidiano
líquor 	líquido que banha o cérebro e a medula espinhal; o mesmo que líquido cérebro-espinal e líquido cefalorraquidiano
lipídeo 	moléculas orgânicas importantes para os seres vivos e que funcionam como reserva energética, isolante térmico, impermeabilizante, entre outras funções
lipídio 	moléculas orgânicas importantes para os seres vivos e que funcionam como reserva energética, isolante térmico, impermeabilizante, entre outras funções
lobo frontal 	parte do cérebro responsável pela coordenação motora voluntária, pela coordenação muscular, pelos movimentos rítmicos da cabeça e do pescoço e pelas funções da linguagem 
lóbulo frontal 	parte do cérebro responsável pela coordenação motora voluntária, pela coordenação muscular, pelos movimentos rítmicos da cabeça e do pescoço e pelas funções da linguagem 
lobo occipital 	parte do cérebro responsável pelos processos de percepção e reconhecimento visual; diretamente ligado ao nosso sentido da visão; o mesmo que córtex visual
lóbulo occipital 	parte do cérebro responsável pelos processos de percepção e reconhecimento visual; diretamente ligado ao nosso sentido da visão; o mesmo que córtex visual
lobo parietal 	parte do cérebro responsável por processar as sensações, as memórias e a orientação espacial; passa boa parte das infofrmações para as outras regiões do cérebro 
lóbulo parietal 	parte do cérebro responsável por processar as sensações, as memórias e a orientação espacial; passa boa parte das infofrmações para as outras regiões do cérebro 
lobo temporal 	partes laterais do cérebro, responsáveis por várias funções, como reconhecer rostos, articular a linguagem, compreender sons, manter o equilíbrio e regular as emoções (motivação, raiva, ansiedade, prazer, etc.)
lóbulo temporal 	localizados dos dois lados do cérebro, são responsáveis por várias funções, como reconhecer rostos, articular a linguagem, compreender sons, manter o equilíbrio e regular as emoções (motivação, raiva, ansiedade, prazer etc.)
lombalgia 	dor da região lombar da coluna
lombar 	fica localizada na região inferior da coluna
lrrk2 	gene considerado pelos especialistas como uma das causas mais comuns da Doença de Parkinson
luxação 	lesão em que uma articulação (extremidade dos ossos) é deslocada da posição normal, provocando dor intensa, limitação nos movimentos, inchaços e hematomas
macrogol 	também conhecido como polietilenoglicol, medicamento para tratar a constipação em crianças e adultos
macroscópico 	grande o suficiente para ver a olho nu
magnésio 	mineral encontrado em diversos alimentos como sementes, amendoim e leite, e desempenha várias funções no organismo, como regular o funcionamento dos nervos e dos músculos e ajudar no controle do açúcar no sangue
mal de alzheimer 	denominação a ser evitada por poder causar preconceito ou discriminação. Usar Doença de Alzheimer ou só Alzheimer.
mal de parkinson 	denominação a ser evitada por poder causar preconceito ou discriminação. Usar Doença de Parkinson. *Ver Doença de Parkinson no glossário.
malformação congênita 	defeito de nascença, transmitido pelos  pais ou produzido por algo no meio ambiente durante a gravidez
mandíbula 	componente móvel do crânio que forma a parte inferior da cabeça; o mesmo que maxilar inferior
manifestações clínicas 	conjunto de sinais e sintomas presentes em uma determinada doença
manobra de valsava 	realizada ao se exalar o ar forçadamente contra os lábios fechados e o nariz tapado, forçando o ar em direção ao ouvido
manômetro 	instrumento usado para medir a pressão de gases e líquidos
marcar passo 	sistema, inserido por cirurgia dentro do corpo, que envia impulsos elétricos ao coração para regular o seu ritmo
marcha 	movimento da caminhada de uma pessoa
marcha patológica 	movimento anormal da caminhada de uma pessoa
máscara parkisoniana 	sintoma de doenças como Parkinson entre outras. fisionomia inexpressiva, mímica facial diminuída; olhar parado, vago e fixo
massa branco 	parte do cérebro que é ativada quando a pessoa quer fazer algo
massa cinzento 	parte do cérebro que coordena as atividades dos músculos da pessoa; o mesmo que substância cinzenta
mastigação 	ato de triturar o alimento com os dentes
material genético 	conjunto de genes de um organismo vivo
medicação 	remédio
medicalização 	processo em que o modo de vida dos homens é apropriado pela medicina e que interfere na construção de conceitos, regras de higiene, normas de moral e costumes
medicamento de uso contínuo 	medicamento que a pessoa não pode nunca parar de tomar
medicamento genérico 	medicamento com a mesma substância ativa, forma farmacêutica e dosagem e com a mesma indicação que o medicamento original, de referência, sem o nome de fantasia
medula adrenal 	a pesquisar
medula espinal 	responsável por conduzir impulsos nervosos das regiões do corpo até o cérebro, produzir impulsos e coordenar atividades musculares e reflexos
medula espinhal 	responsável por conduzir impulsos nervosos das regiões do corpo até o cérebro, produzir impulsos e coordenar atividades musculares e reflexos
medula oblongo 	parte inferior do tronco cerebral que liga e estabelece a comunicação entre o cérebro e a medula espinhal; o mesmo que bulbo e bulbo raquidiano
medula óssea 	tecido existente no interior dos ossos, também conhecido como tutano, responsável pela produção de células sanguíneas (hemácias, leucócitos e plaquetas); pode ser afetada por algumas infecções, como a tuberculose, e por alguns tipos de câncer
melanina 	pigmento escuro que dá coloração à pele e ao cabelo e também está presente na coroide do globo ocular
melanócito 	célula responsável pela fabricação de pigmento (melanina)
melanona 	tipo de câncer de pele que tem origem nas células produtoras de melanina, substância que determina a cor da pele
melanúria 	presença de melanina na urina
melatonina 	hormônio ligado ao ciclo circadiano, ou seja, a forma como o organismo organiza suas funções quando estamos acordados e durante o sono
melena 	fezes escuras devido à presença de sangue, sinal de hemorragia digestiva alta
membrana celular 	película permeável que envolve a célula
membrana plasmática 	estrutura que isola a célula do ambiente; é uma película muito fina e delicada que "fiscaliza" todas as substâncias e partículas que entram e saem da célula
membro inferior 	quadril, coxas, pernas e pés
membro superior 	braços, antebraços, punhos e mãos
meninge 	três membranas que envolvem e protegem o encéfalo, a medula espinhal e outras partes do sistema nervoso central
meningite 	inflamação das meninges (proteções do sistema nervoso central) causada por bactéria ou vírus
menopausa 	fase da vida em que a mulher para menstruar e de produzir óvulos
mesencéfalo 	a pesquisar
mesilato de rasagilina 	medicamento ver
metabolismo 	reações químicas que acontecem nas células do nosso corpo e que transformam os alimentos em energia
metástase 	quando um câncer se espalha
metoclopramida 	medicamento para náuses e vômitos
mialgia 	dor muscular
miastenia 	fraqueza muscular marcada pela paralisia progressiva que pode afetar qualquer músculo do corpo, mas principalmente os da face, língua, garganta e pescoço 
micção 	urinar, fazer xixi
microalbuminúria 	a pesquisar
micróbio 	organismos muito pequenos, que não se consegue enxergar, como vírus e bactérias
microbioma 	a pesquisar
microbiota intestinal 	conjunto de microrganismos que vive em nosso intestino grosso; quando estão em harmonia ajudam no metabolismo e nas defesas do corpo, quando se desequilibram podem causar doenças; o mesmo que flora intestinal
micróglia 	a pesquisar
micrografia 	a pesquisar
micronutriente 	a pesquisar
microrganismo 	a pesquisar
micro organismo 	a pesquisar
microscópico 	muito pesqueno; visto apenas com um microscópio
microscópio 	aparelho com lentes que permite a pessoa enxergar coisas muito pequenas
mielina 	bainha protetora que cobre os nervos
miocárdio 	músculo que controla as contrações produzidas pelo batimento cardíaco
miocimia 	a pesquisar
mioclonia 	a pesquisar
miologia 	estudo dos músculos
miomatose 	a pesquisar
miopatia 	qualquer doença muscular
miorrexia 	ruptura muscular
miosite 	inflamação de um músculo
miossarcoma 	tumor maligno no músculo
mitocôndria 	partícula envolvida por membrana responsável pela respiração celular, permitindo que a célula obtenha energia dos alimentos absorvidos
molécula 	a menor partícula em que um elemento ou composto pode ser dividido sem mudar suas propriedades químicas e físicas
moléstia 	doença
monoplegia 	paralisia de um membro
morbidade 	número de casos de uma doença em grupo populacional
mórber 	que tem a ver com a morte
morfina 	medicamento de alto poder analgésico usado para aliviar dores severas
motricidade 	movimentos voluntários do corpo
movimento voluntário 	movimento(s) do corpo que se realizam  por vontade própria
movimento involuntário 	movimento do corpo que acontece sem a pessoa desejar
mptp 	a pesquisar
muco 	secreção, fluído elástico de origem biológica, ranho
mucosa 	revestimento úmido da pele, como dentro do nariz e boca
mucosite 	inflamação das mucosas
multifatorial 	que possui vários fatores envolvidos
muscular 	a pesquisar
músculo 	músculos são como o motor do aparelho locomotor, pois proporcionam a força necessária para movimentar os vários segmentos do corpo e para manter o equilíbrio
músculo estriar cardíaco 	músculo que controla as contrações produzidas pelos batimentos cardíacos; o mesmo que miocárdio
músculo estriar 	músculos voluntários que movem os ossos e dão sustentação ao esqueleto
músculo estriar esquelético 	músculos que movimentam todos os ossos, a face e os olhos; o corpo controla consientemente a atividade de músculos estriados
músculo esquelético 	músculos voluntários que movem os ossos e dão sustentação ao esqueleto
músculo visceral 	músculos involunátios que movimentam os órgãos internos, como o trato digestivo; o corpo não tem controle consciente sobre esses músculos; o mesmo que músculo liso e músculo não estriado
músculo não estriar 	músculos involunátios que movimentam os órgãos internos, como o trato digestivo; o corpo não tem controle consciente sobre esses músculos; o mesmo que músculo liso e músculo não estriado
músculo liso 	músculos involunátios que movimentam os órgãos internos, como o trato digestivo; o corpo não tem controle consciente sobre esses músculos; o mesmo que músculo liso e músculo não estriado
mutação 	alteração, mudança
mutação genética 	corresponde à alteração de um gene, podendo afetar seu funcionamento normal
nac 	núcleo accumbens
narcolepsia 	crises de sono profundo, de breve duração 
nasogástrico 	do nariz e do estômago
náusea 	enjoo ou ânsia de vômito
nb 	núcleos da base
necropsia 	exame de um corpo morto
necrose 	morte de uma célula
nefrolitíase 	pedras nos rins
nefrologia 	estudo do rim, suas funções e doenças
nefrologista 	médico especializado em doenças e tratamento dos rins
néfron 	menor unidade funcional do rim
nefrose 	distúrbio renal que faz com que o corpo excrete proteína em excesso na urina
neoadjuvante 	terapia realizada antes do tratamento principal
neoestriar 	a pesquisar
neoplasia 	crescimento anormal de um grupo de células; o mesmo que tumor
neoplasma 	aumento anormal, pode ser um tumor (*definição de tumor) ou um cisto (*definição de cisto)
nerlurin 	a pesquisar
nervo 	partes do corpo semelhantes a fios que se dividem e se ligam, transportando mensagens dos órgãos dos sentidos para o cérebro e instruções do cérebro para outras partes do corpo
nervo craniano 	a pesquisar
nervo eferente 	a pesquisar
nervo espinhal 	a pesquisar
nervo facial 	a pesquisar
nervo óptico 	a pesquisar
nervo periférico 	a pesquisar
nervo radial 	a pesquisar
nervo aferente 	a pesquisar
neuralgia 	dor em um nervo
neurite 	inflamação de um nervo
neuroacantocitose 	a pesquisar
neurocirurgião 	médico que opera em casos de problemas no cérebro e em outras parte sistema nervoso central
neurocomportamental 	a pesquisar
neurodegeneração 	destruição dos neurônios (células do sistema nervoso) que acontece aos poucos e que não tem recuperação
neurodegenerativo 	relacionado à destruição dos neurônios (células do sistema nervoso)
neuroendoscopia 	a pesquisar
neuroestimulador 	a pesquisar
neurofarmacologia 	a pesquisar
neuróglia 	a pesquisar
neuroléptico 	a pesquisar
neurologia 	ramo da medicina que estuda o sistema nervoso, suas funções e desordens
neurologista 	médico especializado no estudo do sistema nervoso, suas funções e doenças
neuroma 	tumor composto de células nervosas
neuromuscular 	a pesquisar
neurônio 	célula do sistema nervoso (cérebro e medula espinhal) que processa informações e gera respostas no corpo
neurônio colinérgico 	a pesquisar
neurônio dopaminérgico 	neurônios que produzem e liberam dopamina
neurônio gabaérgico 	neurônios que secretam GABA
neuropatia 	doença(s) do sistema nervoso (*definição de sistema nervoso)
neuropatia autônoma 	doenças que afetam os nervos que regulam automaticamente (sem esforço consciente) os processos do corpo; a pessoa pode sentir tontura, ter problema para controlar a bexiga, intestino preso, entre outros sintomas
neuropatia autonômica 	doenças que afetam os nervos que regulam automaticamente (sem esforço consciente) os processos do corpo; a pessoa pode sentir tontura, ter problema para controlar a bexiga, intestino preso, entre outros sintomas
neuropática 	tipo de sensação dolorosa que ocorre em uma ou mais partes do corpo e é associada a doenças que afetam o Sistema Nervoso Central, ou seja, os nervos periféricos, a medula espinhal ou o cérebro
neuroplastia 	capacidade de um tecido neural se reagrupar
neuroproteção 	mecanismos e estratégias usados para proteger os neurônios contra danos decorrentes de enfermidades que afetam o Sistema Nervoso Central
neuropsicológico 	a pesquisar
neuroquímico 	a pesquisar
neurose 	a pesquisar
neurotransmissor colinérgico 	a pesquisar
neurotransmissor noradrenérgico 	a pesquisar
neurotransmissor serotoninérgico 	a pesquisar
neurotransmissor 	mensageiros químicos que transportam, estimulam e equilibram os sinais entre os neurônios (*Ver neurônio no glossário) e outras células do corpo
nicotina 	substância química que tem no fumo e em cigarros e assemelhados
nictúria 	urinar com frequência durante a noite (o mesmo que noctúria)
nistagmo 	movimento involuntário dos olhos que pode fazer o olho mover-se de um lado para outro, para cima e para baixo ou em círculos
nível sérico 	quantidade de uma substância no sangue
noctúria 	urinar com frequência durante a noite (o mesmo que nictúria)
noradrenalina 	o mesmo que norepinefrina
norepinefrina 	o mesmo que noradrenalina
núcleo 	parte da célula onde está o DNA genômico e onde ocorre a síntese do RNA. Corpúsculo esférico que constitui a parte essencial da célula
núcleo accumbem 	a pesquisar
núcleo caudar 	a pesquisar
núcleo lenticular 	a pesquisar
núcleo lentiforme 	a pesquisar
núcleo putâmem 	a pesquisar
núcleos de o base 	partes do cérebro que se comunicam e cuidam, por exemplo, da coordenação motora e da cognição
nurr1 	a pesquisar
nutrição 	alimentação
nutricional 	que tem a ver com alimentação
nutricionista 	profissional graduado que cuida da alimentação de uma pessoa
nutrólogo 	a pesquisar
obnubilação 	paciente muito sonolento, ou seja, necessita ser estimulado intensamente, com associação de estímulo auditivo mais intenso e estímulo tátil
óbito 	morte 
obesidade 	peso acima do normal
obstipação 	prisão de ventre
ocluir 	fechar hermeticamente
oclusão 	fechamento
oclusão carotídea 	a pesquisar
ocupacional 	que tem a ver com o trabalho ou com o que a pessoa faz
odontologia 	especialidade médica que cuida da saúde da boca das pessoas
odontológico 	que tem a ver com a saúde da boca de uma pessoa
odontólogo 	profissional graduado que cuida da saúde da boca de uma pessoa
oleaginoso 	ricas em óleos ou gorduras
oftálmico 	dos olhos
oftalmologia 	parte da medicina que cuida das doenças e tratamento dos olhos
oftalmológico 	médico que cuida das saúde dos olhos das pessoas
oftalmologista 	médico especializado nas doenças e tratamento dos olhos
oftalmoparesia 	a pesquisar
oftalmoparesia vertical suprir 	dificuldade para olhar para baixo
olfanação 	a pesquisar
olfativo 	que tem a ver com a capacidade de sentir cheiros
olfato 	um dos cinco sentidos; processo de sentir cheiros
oligocinesia 	lentidão e redução da atividade motora espontânea, na ausência de paralisia. Há também uma grande dificuldade para se dar início aos movimentos
oligúria 	diminuição ou ausência de produção de urina
orientação alopsíquica 	diz respeito à capacidade de orientar-se em relação ao mundo, isto é, quanto ao espaço (orientação espacial ) e ao tempo (orientação temporal)
orientação espacial 	capacidade de se orientar no espaço ou ambiente
orientação temporal 	capacidade de se orientar no tempo ou épocas
ortodontista 	dentista que cuida do posicionamento correto dos dentes
ortopneia 	dificuldade de respirar a menos que se esteja de pé
ossififcação 	processo de formação do osso
osteo 	relativo ao osso
osteopatia 	a pesquisar
osteopenia 	deficiência da massa óssea
osteoporose 	doença em que os ossos ficam porosos e fracos
otite 	infecção no ouvido
palato 	céu da boca
paladar 	sentir gostos
palato duro 	serve para oferecer uma certa resistência à língua durante a mastigação e a deglutição
palato mole 	encarrega-se de bloquear a passagem dos alimentos para as fossas nasais no momento de os engolir
palidectomia 	a pesquisar
palidotomia 	a pesquisar
palilalia 	a pesquisar
palpação 	apalpar com a palma da mão ou com os dedos
pálpebra 	parte do olho acima dos cílios ou pestanas
palpitação 	batimento acelerado do coração
pâncreas 	a pesquisar
pancreatite 	inflamação do pâncreas
pandemia 	disseminação mundial de uma doença para dois ou mais continentes, termo usado principalmente em relação à gripe
parada cardiorrespiratória 	a pesquisar
paralisia 	perda da capacidade de movimento voluntário de um músculo, que pode ser causada por doenças no próprio músculo ou por doenças neurológicas
paralisia agitante 	nome antigo e inicial para Doença de Parkinson 
paralisia cerebral 	a pesquisar
paralisia facial 	a pesquisar
paralisia supranuclear progressiva 	a pesquisar
parâmetros cinemático 	a pesquisar
parâmetros eletromiográfico 	a pesquisar
parâmetros espaço temporal 	a pesquisar
paranoia 	a pesquisar
parapesia 	paralisia da metade inferior do corpo; o mesmo que paraplesia
paraplegia 	paralisia da metade inferior do corpo
parassimpatomimético 	a pesquisar
parênquia hepático 	tecido do fígado
parênquima cerebral 	tecido do cérebro
parestesia 	sensação de latejamento, formigamento ou dormência em uma região do corpo, sem um efeito físico aparente
parkinsoniano 	pessoa que tem a Doença de Parkinson
parkinsonismo 	síndrome, conjunto de sintomas, com tremores e lentidão de movimentos semelhantes à Doença de Parkinson, mas que não é Doença de Parkinson 
paroxística 	espasmos
patogênese 	a pesquisar
patógeno 	organismo capaz de produzir doenças infecciosas aos seus hospedeiros sempre que esteja em circunstâncias favoráveis, podem ser bactérias, vírus, fungos, entre outros, o mesmo que agente patogênico
patogenia 	o que causa a doença
patologia 	ramo da medicina que estuda as doenças e seus efeitos; o mesmo que doença
patológico 	relativo à doença
patologista 	médico que diagnostica doenças examinando tecidos e células com um microscópio; também realiza autópsias (*Ver autópsia no glossário)
pedículo cerebelar superior 	a pesquisar
pelve 	osso do quadril
perfusão 	bombeamento de um líquido através de um órgão
pericardial 	ao redor do coração
periodicidade 	a pesquisar
períodos off 	intervalos de tempo entre as doses nos quais a medicação perde a eficácia
periósteo 	membrana que recobre o osso, sendo a única parte do osso sensível à dor
períneo 	região do corpo humano que começa, para as mulheres, na parte de baixo da vulva e estende-se até o ânus; no homem, localiza-se entre o saco escrotal e o ânus
peristaltismo 	Movimento de contração do tubo digestivo em onda progressiva, de cima para baixo, de forma a deslocar seu conteúdo no sentido do ânus
peritônio 	tipo de membrana que reveste a parte interna do abdômen
perna agitar 	a pesquisar
pesticida 	substância usada para matar pragas na agricultura, agrotóxico
pilates 	conjunto de exercícios físicos, ministrados por profissional habiltado, feitos de acordo com o método inventado por Joseph Pilates em 1920
pink1 	a pesquisar
piridoxina 	vitamaina antioxidante, conhecida como vitamina B-6, atua no sistema nervoso para produzir hormônios importantes
placebo 	a pesquisar
plaquetária 	a pesquisar
plaqueta 	a pesquisar
plasma 	a pesquisar
plasmócito 	Célula do sangue, originada na medula óssea e que pertence ao sistema imunológico do ser humano
plasticidade 	capacidade de uma área do cérebro de alterar sua função
pleura 	membrana que reveste o pulmão
pleura visceral 	a pesquisar
pneumologia 	a pesquisar
pneumologista 	a pesquisar
pneumonia 	infecção no pulmão
polidipsia 	sensação excessiva de sede (sintoma da diabetes)
polineurite 	inflamação de muitos nervos
pólipo 	a pesquisar
polissintomática 	a pesquisar
poliúria 	micção excessiva ou frequente
porção reticular 	parte da substância negra (*definição de substância negra) que interfere no tônus muscular
portador 	pessoa que tem alguma doença, condição ou necessidade especial. Em vez de "portador [da Doença] de Parkinson", use "pessoa com Parkinson"
pós operatório 	a pesquisar
potência de gama 	a pesquisar
pramipexol 	a pesquisar
praxia 	movimento intencional, organizado, tendo em vista a obtenção de um fim ou de um resultado determinado. Não é um movimento reflexo, nem automático, é um movimento voluntário, consciente, intencional, organizado
prejuízo funcional 	a pesquisar
pré mórbido 	a pesquisar
presbiopia 	problema de visão devido ao envelhecimento
prescrição 	receita dada por um médico para um remédio; rotina de cuidados com a saúde implementadas por um médico ou outro profissional de saúde qualificado para um paciente específico
pressão sanguínea 	pressão exercida pelo sangue contra as paredes dos vasos
procedimento estereotáxico 	procedimento de exame em que um aro é fixado em torno da cabeça do paciente para que o médico possa, com auxílio de um exame de imagem, direcionar, com precisão, um instrumento até um ponto exato dentro do cérebro da pessoa.
prognóstico 	conhecimento ou juízo antecipado, feito pelo médico, baseado necessariamente no seu diagnóstico nas possibilidades terapêuticas, segundo o conhecimento atual, acerca da duração, da evolução e do eventual término ou desfecho de uma doença ou quadro clínico sob seu cuidado ou orientação.
pronação 	a pesquisar
prontuário médico 	conjunto de documentos padronizados destinados ao registro do atendimento prestado ao paciente
propriocepção 	capacidade de perceber a posição de partes do corpo ou sua totalidade em relação ao espaço, além da percepção do movimento do corpo
propulsão 	a pesquisar
prosódia 	melodia da fala
prosopagnosia 	incapacidade de reconhecer rostos conhecidos, como de amigos 
próstata 	a pesquisar
proteico 	rico em proteínas
proteína 	a pesquisar
proteína g 	a pesquisar
protocolo clínico 	Estabelece claramente os critérios de diagnósticos de cada doença, o tratamento preconizado com os medicamentos disponíveis nas respectivas doses corretas, os mecanismos de controle, o acompanhamento e a verificação de resultados, e a racionalização da prescrição e do fornecimento dos medicamentos
protrusão 	deslocamento de um órgão para a frente
proximal 	mais próximo ao membro
prurir 	coceira
psicogênico 	a pesquisar
psicologia 	estudo da mente, dos processos mentais e do comportamento humano
psicólogo 	a pesquisar
psicose 	doença mental caracterizada por uma perturbação extrema, com frequência acompanhada de delírios e alucinações
psicossomático 	referente à mente e o corpo
psicoterapeuta 	a pesquisar
psicoterapêutico 	a pesquisar
psicoterápico 	a pesquisar
psicotrópico 	a pesquisar
psiquiatra 	a pesquisar
psiquiatria 	a pesquisar
psns 	o mesmo que Parassimpatomimético
púbis 	a pesquisar
pulmões 	a pesquisar
pulmonar 	relativo aos pulmões
pulsátil 	a pesquisar
punção 	a pesquisar
pupilo 	a pesquisar
pupilo dilatar 	a pesquisar
purgativo 	laxante forte
purina 	componentes fundamentais ao DNA (*definição de DNA) presentes no nosso organismo e em alimentos como carne vermelha, frutos do mar, peixes, certos grãos como ervilha, lentilha e feijão, em bebidas alcoólicas, principalmente cerveja
pústula 	área de pus em discreto relevo na pele
putâmen 	a pesquisar
quadríceps 	músculo da coxa
queimação 	a pesquisar
queloide 	cicatriz espessa que cresce de forma anormal
quimioluminescência 	a pesquisar
quimioterapia 	a pesquisar
radiofrequência 	a pesquisar
radiografia 	a pesquisar
radioterapia 	a pesquisar
raio x 	imagem dos ossos
raio x 	imagem dos ossos
rasagilina 	a pesquisar
rash 	a pesquisar
reabilitação 	a pesquisar
reação alérgica 	a pesquisar
reações adverso 	são quaisquer reações indesejadas a um medicamento
receptor adrenérgico 	a pesquisar
receptor colinérgico 	a pesquisar
receptor dopaminérgico 	a pesquisar
receptor pós sináptico 	a pesquisar
redundância 	capacidade de mais de uma área do cérebro de desempenhar a mesma função
reflexo de estiramento 	o mesmo que reflexo miotático
reflexo de flexão 	a pesquisar
reflexo de flexão 	a pesquisar
reflexo de retirada 	a pesquisar
reflexo miotático 	o mesmo que reflexo de estiramento
reflexo 	reação corporal automática
refluxo 	a pesquisar
refluxo gastroesofágico 	a pesquisar
regurgitação 	retorno de sólidos ou fluidos para a boca vindos do estômago
remissão 	a pesquisar
reserpina 	a pesquisar
respiração diafragmática 	a pesquisar
resposta imunológica 	a pesquisar
ressonância 	a pesquisar
ressonância magnética 	exame de imagem de alta definição usado para detectar doenças neurológicas, ortopédicas, abdominais, cervicais e cardíacas
retardo mental 	condição, geralmente irreversível, caracterizada por uma capacidade intelectual inferior à normal com dificuldades de aprendizado e de adaptação social, que normalmente está presente desde o nascimento ou que se manifesta nos primeiros anos da infância
retenção fecal 	a pesquisar
retenção urinária 	a pesquisar
retrocolo 	a pesquisar
retropulsão 	tendência de cair para trás
retrovírus 	tipo de vírus; o HIV (que causa a AIDS) é um tipo de retrovírus
ribossomos 	estruturas responsáveis pela síntese de proteínas nas células
rigidez 	endurecimento
rigidez muscular 	endurecimento dos músculos
rinite 	inflamação da mucosa do nariz, que causa coceira, olhos lacrimejantes, espirros etc.
rim 	dois órgãos que filtram e eliminam substâncias tóxicas do corpo
ritmo circadiano 	oscilação em um período de 24 horas dos parâmetros fisiológicos, metabólicos e comportamentais
rna 	a pesquisar
ropinirol 	a pesquisar
rotigotina 	a pesquisar
saturação 	a pesquisar
seborreia 	produção em excesso de sebo gordura pela glândulas sebáceas
secreção 	a pesquisar
secretar 	a pesquisar
sedação 	tipo de anestesia; técnica que permite a diminuição dos níveis de consciência do paciente, mantendo suas funções vitais, como respiração, deglutição etc.
sedado	anestesiado
sedar 	anestesiar
sedativo 	que anestesia
sedentário 	pessoa que passa muito tempo inativa, isto é, sem fazer exercícios físicos
sedentarismo 	situação em que a pessoa não pratica qualquer tipo de atividade física regularmente, além de permanecer muito tempo sentada e não ter disposição para realizar atividades simples do dia a dia, o que tem influência direta na saúde e bem-estar da pessoa
selegilina 	medicamento para Doença de Parkinson
sêmen	esperma; porra; líquido produzido pelo corpo do macho para levar seus espermatozóides até o óvulo dentro do corpo da fêmea
semiologia 	a pesquisar
semiológico 	a pesquisar
sequenciamento de exoma 	exame que identifica doenças genéticas
sequenciamento de dna 	a pesquisar
sepse 	quando substâncias químicas liberadas na corrente sanguínea para combater uma infecção desencadeiam uma inflamação em todo o corpo
sépsis 	quando substâncias químicas liberadas na corrente sanguínea para combater uma infecção desencadeiam uma inflamação em todo o corpo
serotonina 	substância encontrada em tecidos humanos e animais, especialmente no cérebro e nas mucosas gástricas, que desempenha importante função como neurotransmissor, vasoconstritor e regulador da atividade dos músculos lisos.
sialorreia 	saliva que escorre para fora da boca
sinal vital 	a pesquisar
sinal de babinski 	em casos de lesão dos tratos córtico-espinais, o dedão dobra para trás ao estímulo da pele da parte de baixo do pé (quando a resposta normal seria dobrar para baixo)
sinapse 	a pesquisar
sinapse colinérgica 	a pesquisar
sincinesia 	tendência patológica para a execução simétrica de qualquer movimento, de qualquer contração muscular que executa um membro (a mão em geral) sem que a associação possua um significado funcional
síncope 	desmaio ou perda repentina da consciência
síndrome de parkinson	sintomas relacionados com a doença de Parkinson, como tremor, lentidão e outros
síndrome de shy drager 	a pesquisar
síndrome extrapiramidal 	a pesquisar
síndrome parkisoniana 	o mesmo que parksinsonismo, conjunto de sintomas semelhantes à Doença de Parkinson
sinemet 	medicamento para Doença de Parkinson
sintetização 	produção; agrupamento
sintetizar 	produzir; agrupar
sintoma 	o que a pessoa sente quando tem uma doença
sintoma autonômico 	intolerância ao calor, suor excessivo, constipação intestinal, entre outros
sintoma neurovegetativo 	náuseas, vômitos, palidez
sintomático 	que apresenta sintomas; sinais de uma condição ou doença
sintomatologia 	sintomas ou sinais de uma condição ou doença
sinucleína 	a pesquisar
siringomesencefalia 	a pesquisar
sistema cardiovascular 	a pesquisar
sistema digestivo 	formado por vários órgãos como boca, faringe, esôfago, estômago, intestino delgado, intestino grosso, reto, fígado e pâncreas, é responsável por transformar os alimentos que comemos em combustível para o nosso corpo funcione.
sistema digestório 	formado por vários órgãos como a  boca, faringe, esófago, estômago, intestino delgado, intestino grosso, reto, fígado e pâncreas, é  boca, faringe, esófago, estômago, intestino delgado, intestino grosso, reto, fígado e pâncreas, é responsável por obter dos alimentos ingeridos os nutrientes necessários às diferentes funções do organismo, como crescimento, energia para reprodução, locomoção, etc
sistema endócrino 	sistema que mantém o equilíbrio químico do corpo, trabalha em conjunto com o sistema nervoso para regular os outros sistemas. Isso é feito enviando mensageiros chamados hormônios através do corpo via corrente sanguínea.
sistema esquelético 	a pesquisar
sistema excretor 	a pesquisar
sistema extrapiramidal 	a pesquisar
sistema imune 	conjunto de órgãos, tecidos e células responsáveis pelo combate a microrganismos invasores, impedindo, assim, o desenvolvimento de doenças
sistema imunológico 	conjunto de órgãos, tecidos e células responsáveis pelo combate a microrganismos invasores, impedindo, assim, o desenvolvimento de doenças
sistema límbico 	responde pelos comportamentos instintivos, pelas emoções profundamentes arraigadas e pelos impulsos básicos, como sexo, ira, prazer e sobrevivência.
sistema linfático 	responsável por coletar impurezas da circulação e manter nossas defesas vigilantes contra os micróbios
sistema motor extrapiramidal 	sistema que atua principalmente nos movimentos inconscientes do corpo, como o caminhar, o equilíbrio, a escrita, entre outros
sistema muscular 	formado pelo conjunto de músculos do nosso corpo. Os músculos se contraem e relaxam, gerando movimentos que nos permitem andar, correr, impulsionar o alimento ao longo do tubo digestório, promover a circulação do sangue no organismo, urinar, dentre muitas outras atividades. 
sistema nervoso autônomo 	parte do sistema nervoso que controla funções como a respiração, circulação do sangue, temperatura e digestão
sistema nervoso central 	rede de comunicação do nosso corpo formada pelo cérebro, medula espinhal e nervos
sistema nervoso parassimpático 	a pesquisar
sistema nervoso periférico 	nervos; liga o sistema vervoso central aos outros órgãos do corpo para transportar informações
sistema nervoso visceral 	parte do sistema nervoso que controla funções como a respiração, circulação do sangue, temperatura e digestão
sistema neurovegetativo 	parte do sistema nervoso que controla funções como a respiração, circulação do sangue, temperatura e digestão
sistema parassimpático 	a pesquisar
sistema reprodutor 	órgãos que trabalham em conjunto pela reprodução; na mulher são a vagina, os ovários, as trompas e o útero e no homem são os testículos, o pênis, o escroto e a prostata  
sistema respiratório 	formado pelo nariz, faringe, laringe, traqueia, brônquios e pulmões, nesta ordem
sistema simpático 	a pesquisar
sistema tegumentar 	a pesquisar
sistema urinário 	órgãos que trabalham em conjunto para a produção, depósito e eliminação da urina, sendo eles dois rins, dois ureteres, uma bexiga e uma uretra
sistole 	fase de contração da batida do coração
snc 	Sistema Nervoso Central
sobrar 	a pesquisar
sonambulismo 	quando a pessoa anda e fala dormindo
sonho vívido 	sonhos que parecem reais
sono rem 	fase do sono em que a pessoa sonha
sonolência 	grande vontade de dormir; sentir muito sono
subcostal 	abaixo das costelas
subcutâneo 	localizado sob a pele
sublingual 	debaixo da língua
substância cinzento 	responsável por interpretar os impulsos nervosos das regiões do corpo até o encéfalo, produzir impulsos e coordenar atividades musculares e reflexos; o mesmo que massa cinzenta; 
substância negro 	porção do cérebro que é responsável pela produção de dopamina (*Ver dopamina no glossário)
substância nigra 	porção do cérebro que é responsável pela produção de dopamina (*Ver dopamina no glossário)
suceptibilidade genética 	a pesquisar
sudorese 	suor excretato, transpiração
sujeito controlo 	a pesquisar
suplementação 	que completa
sutura 	tipo de ligação usada por médicos e cirurgiões-dentistas para manter unido pele, músculos, vasos sanguíneos e outros tecidos do corpo humano, após terem sido seccionados por um ferimento; ponto cirúrgico
tálamo 	parte do cérebro responsável por receber informações relacionadas aos sentidos, como audição, paladar, tato, visão (menos o olfato) e enviá-las para o córtex cerebral (*Ver córtex cerebral no glossário), onde essas informações serão processadas
talamotomia 	a pesquisar
taquicardia 	batimentos cardíacos rápidos
taquifemia 	a pessoa passa a agrupar as palavras
taquilalia 	caracterizada por uma taxa de articulação ("velocidade de fala") elevada, suficientemente intensa para prejudicar a inteligibilidade da mensagem
tarefa motor fino 	tarefas que exigem coordenação fina, como abotoar roupas, amarrar sapatos, cortar unhas, pentear cabelos, usar talheres etc.
taxa de letalidade 	proporção entre o número de mortes por uma doença e o número total de doentes que sofrem dessa doença, ao longo de um determinado período de tempo
tdh 	a pesquisar
tecido adiposo 	tecido de gordura
tecido conectivo 	sustenta e reveste as estruturas corporais, mantém os orgãos no lugar e conecta as partes do corpo entre si; os ossos e cartilagens são exemplos de tecidos conectivos
tecido conjuntivo 	sustenta e reveste as estruturas corporais, mantém os orgãos no lugar e conecta as partes do corpo entre si; os ossos e cartilagens são exemplos de tecidos conjuntivos
tecido epitelial 	encontrado na pele e no revestimento dos vasos sanguíneos; forma a cobertura das superfícies internas e externas do corpo e o revestimento dos tratos digestivo, respiratório e urinário 
tecido fibroso 	a pesquisar
tecido mole 	a pesquisar
tecido muscular 	tecido que proporciona movimento; sua função principal é contrair-se
tecido muscular liso 	tecido que apresenta uma contração lenta e involuntária e forma a musculatura dos órgãos internos, como a bexiga, estômago, intestino e vasos sanguíneos
tecido muscular estriar esquelético 	apresenta uma contração rápida e voluntária e está ligado aos ossos e atua na movimentação do corpo
tecido estriado cardíaco 	a pesquisar
tecido nervoso 	tecido que conduz impulsos de e para o cérebro e é composto de células nervosas chamadas de neurônios
telencéfalo 	a pesquisar
tendão 	tecido conectivo que une os músculos aos ossos
tendinite 	inflamação nos tendões
terapêutica 	que trata
terapêutica 	tratamento
terapia ocupacional 	campo de conhecimento da área da saúde que tem como principal objetivo promover o bem-estar e a qualidade de vida de pessoas de todas as idades, capacitando-as para a ocupação
terapeuta ocupacional 	profissional graduado em terapia ocupacional, que cuida do  bem-estar e da qualidade de vida de pessoas de todas as idades, capacitando-as para a ocupação
terapia protetora 	a pesquisar
terapia sintomática 	a pesquisar
termocoagulação 	a pesquisar
termo de consentimento 	documento em que a pessoa concorda com algo
testosterona 	hormônio  sexual masculino
tetania 	doença neurológica que causa espasmos(contrações) dos músculos, normalmente a flexão acentuada dos pulsos ou articulações do tornozelo
tímpano 	membrana do ouvido
tique 	movimentos ou sons súbitos, rápidos e involuntários
tireoide 	localizada na parte anterior do pescoço, é uma das maiores grândulas do corpo e age na função de órgãos importantes como o coração, cérebro, fígado e rins, além de interferir em várias outras funções como o crescimento das crianças e adolescentes, ciclo menstrual da mulher e muito mais
tirosina 	substância encontrada em carnes brancas e vermelhas e frutos do mar e que forma a dopamina. Ver dopamina no Glossário.
tolcapone 	medicamento para Doença de Parkinson
tomografia 	tipo de exame de diagnóstico por imagem
tomografia computadorizada 	tipo de exame de diagnóstico por imagem
tônus muscular 	condição dos músculos que permite a boa sustentação do corpo, incluindo a sustentação do órgãos internos
tônus postural 	a pesquisar
topografia de córnea 	exame de oftalmologia que serve para analisar o relevo e curvatura da córnea em toda a sua superfície; o mesmo que topografia corneana
topografia corneana 	exame de oftalmologia que serve para analisar o relevo e curvatura da córnea em toda a sua superfície; o mesmo que topografia de córnea
tórax 	peito
torácico 	do peito
torcicolo 	torcida dolorosa do pescoço
torpor 	paciente sonolento, não responsivo, necessitando de estimulação dolorosa para responder
toxicologia 	a pesquisar
toxina botulínica 	a pesquisar
toxina 	substância tóxica, veneno
tpm 	tensão pré-mestrual
transdução 	processo através do qual uma célula converte um tipo de sinal ou estímulo em outro
transecção 	a pesquisar
transmissão vertical 	o que passa da mãe para seu filho, durante a gravidez, na hora do parto ou pela amamentação
transtorno bipolar 	doença psiquiátrica em que a pessoa tem alterações repentinas de humor
transtorno amnéstico 	a pesquisar
transtorno conversivo 	a pesquisar
transtorno distímico 	a pesquisar
transtorno de o déficit de atenção 	a pesquisar
transtorno de o humor 	transtornos de saúde mental nos quais as alterações emocionais consistem em períodos prolongados de tristeza excessiva (depressão) ou de euforia (mania), ou ambos
transtorno 	a pesquisar
traqueia 	órgão tubular e cilíndrico localizado entre a laringe e os brônquios que filtra, umedece e conduz o ar aos pulmões
traqueostomia 	abertura artificial da traqueia após traqueotomia
traqueotomia 	corte na traqueia (*defifnição de traqueia)
tratamento medicamentoso 	tratamento que envolve o uso de medicamentos
tratamento reabilitacional 	tratamento que envolve exercícios físicos, acompanhamento psicológico etc.
tratamento adjuvante 	tratamento auxiliar
tratamento cirúrgico 	tratamento que envolve cirurgias
tratamento sintomático 	praticado para acalmar ou aliviar os sintomas nas doenças que se desconhecem ou que não têm um tratamento eficaz
trato digestivo 	a pesquisar
trato respiratório 	a pesquisar
trato urinário 	formado pelos rins, ureteres, bexiga e uretra. Ver cada órgão no glossário.
trato córtico espinal 	a pesquisar
trato gastrointestinal 	a pesquisar
trauma craniano 	lesão ou fratura da cabeça
tremor refratário 	a pesquisar
tremor 	a pesquisar
tremor cinético 	a pesquisar
tremor de ação 	a pesquisar
tremor de repouso 	a pesquisar
tremor distal 	a pesquisar
tremor essencial 	problema neurológico em que ocorrem tremores sem que a pessoa consiga controlar, geralmente é confundido com a Doença de Parkinson
tremor postural 	a pesquisar
triagem 	separação, escolhas, filtragem
tricíclico 	a pesquisar
trombócitos 	células de coagulação ou plaquetas
trombose 	formação de um coágulo de sangue dentro do coração ou vasos
trompa de eustáquio 	canal que liga a orelha média à faringe; o mesmo que tuba auditiva
tronco cerebral 	parte embaixo do cérebro, na frente do cerebelo. Liga o cérebro à medula espinhal e controla funções involuntárias (as que fazemos sem perceber), como respiração, digestão, ritmo do coração e pressão arterial
tronco encefálico 	parte do cérebro responsável pelas funções involuntárias, como respiração, ritmo dos batimentos cardíacos e pressão arterial etc. 
tronco de o encéfalo 	parte do cérebro responsável pelas funções involuntárias, como respiração, ritmo dos batimentos cardíacos e pressão arterial etc. 
tuba auditivo 	canal que liga a orelha média à faringe; o mesmo que trompa de Eustáquio
tubo digestivo 	parte do corpo composta pela boca, faringe, esôfago, estômago, intestino delgado e intestino grosso
tubo digestório 	é composto pela boca, faringe, esôfago, estômago, intestino delgado e intestino grosso
tumor 	a pesquisar
turvação visual 	dificuldade para enxergar com niditez
tutela 	guarda, responsabilidade
úlcera 	ferimento  ou lesão da membrana mucosa ou pele
úlcera gástrica 	lesão na parede do estômago
úlcera péptica 	lesão na parede do estômago
ultrassom 	a pesquisar
umbilical 	relacionado ao umbigo
unilateral 	de um lado só
ureia 	susbtância que tem na urina
ureteres 	tubos que levam a urina dos rins para a bexiga, há um ureter do lado direito do rim e outro do lado esquerdo
urologia 	estudo do sistema urinário masculino e feminino e do sistema reprodutivo masculino
urologista 	médico especializado em tratar doenças do sistema urinário masculino e feminino e masculino e do sistema reprodutivo masculino
uso oral 	pela boca
valor acromático 	a pesquisar
valor cromático 	a pesquisar
válvula mitral 	válvula entre o átrio esquerdo e o ventrículo esquerdo
variação fenotipica 	a pesquisar
variz 	inchaço anormal das veias que ocorre normalmente nas pernas devido a válvulas danificadas que falham ao evitar o refluxo de sangue e o sangue acumula causando a distensão das veias
vas 	a pesquisar
vascularização 	a pesquisar
vascularização cerebral 	a pesquisar
vasoconstrição 	a pesquisar
vasoconstritor 	 substância que reduz o calibre dos vasos
vasodilatação 	a pesquisar
vasodilatador 	substância que aumenta o calibre dos vasos
vaso capilar 	os menores vasos sanguíneos; o mesmo que capilares e capilares sanguíneos
vaso sanguíneo 	existem 3 tipos: artérias, veias e capilares
veia cavar 	maior veia do corpo; existem duas veias cavas, a superior e a inferior, e ambas levam sangue para o átrio direito
veia 	a pesquisar
veia pulmonar 	veias que carregam sangue oxigenado dos pulmões ao coração
velocidade autosselecionadar 	a pesquisar
venoso 	que é das veias
ventilação 	auxílio para entrada de ar
ventrículo 	cavidades, espaços
ventrículo cardíaco 	partes do  coração  que são como  câmaras que recebem e bombeiam sangue
ventrículo cardíaco direito 	a pesquisar
ventrículo cardíaco esquerdo 	a pesquisar
vértebras 	ossos da coluna vertebral
vertigem 	sensação de movimento irregular ou giratório do corpo ou de objetos externos causada por distúrbio nos órgão do equilíbrio, como o labirinto 
vesícula 	órgão em forma de bolsa localizado abaixo do fígado que armazena a bile (*Ver bile no glossário)
via aferente 	leva os impulsos nervosos até o sistema nervoso central,
via eferente 	a pesquisar
via nigroestriada 	a pesquisar
via oral 	pela boca
vídeolaparoscopia 	a pesquisar
vírus 	partícula basicamente proteica que pode infectar organismos vivos, causando doenças
vísceras 	partes internas do organismo, como coração, fígado, intestinos, etc.
visomotor 	a pesquisar
wearing off 	a pesquisar
xerostomia 	baixa produção de saliva pelas glândulas salivares
zigoto 	célula resultande da união do espermatozóide e do óvulo
