achatar o curva 	ação para impedir que novo coronavírus se espalhe para um grande número de pessoas;  ajuda os hospitais a se prepararem para receber o maior número de pacientes
adenovírus 	grupo de vírus que normalmente causa doenças respiratórias, como resfriados, bronquite ou pneumonia; pode causar ainda conjuntivite e doenças nos intestinos, com sintomas como diarreia, vômito e dores de barriga
adjuvante 	o que ajuda; remédio ou substância que, combinado a um outro, ou misturado na sua fórmula, reforça a ação do primeiro.
aerossol 	partículas muito pequenas de poluição e poeira ou pequenas gotas que escapam da nossa boca quando falamos, tossimos ou do nosso nariz quando espirramos
afebril 	pessoa sem febre
agente etiológico 	micro-organismos, como bactérias, vírus, fungos etc. que podem causar doenças
agente infeccioso 	micro-organismos como bactérias, vírus, fungos etc. que podem causar doenças
agente patogênico 	micro-organismos como bactérias, vírus, fungos etc. que podem causar doenças
aglomerações 	muitas pessoas juntas num mesmo lugar
álcool em gel 	tipo de álcool em consistência mais cremosa do que líquida; com 70% de álcool na fórmua, mata bactérias, vírus e fungos
álcool etílico 	etanol; álcool produzido a partir da fermentação do açúcar
álcool gel 	tipo de álcool em consistência mais cremosa do que líquida; com 70% de álcool na fórmua, mata bactérias, vírus e fungos
álcool 70 % 	tipo de álcool feito com 70% de massa de álcool e apenas 30% de massa de água, mata bactérias, fungos e vírus. O álcool 70% é melhor para matar bactérias porque a essa quantidade de água facilita a entrada do álcool na bactéria e também deixa a evaporação mais lenta, permitindo maior tempo de contato e de ação. 
ambientes bem ventilar 	ambientes em que o ar consegue circular, com janelas abertas
anosmia 	perda do olfato, capacidade de sentir cheiros
antebraço 	parte do braço que vai do punho até o cotovelo
antibióticos 	remédios utilizados para tratar doenças causadas por bactérias
anticoagulante 	remédios que impedem a formação de coágulos, que são o sangue que engrossa e fica sólido
anticorpo 	proteínas que trabalham como defensores do organismo contra bactérias, vírus e outros corpos estranhos
antígeno 	parte do corpo estranho, como vírus, bactéria etc., que o nosso corpo detecta para gerar defesas
antimicrobiano 	remédios e substâncias que têm capacidade de matar micróbios, como bactérias e fungos
antirretroviral 	remédios para tratar de infecções por um tipo de vírus chamado retrovírus; o HIV é um retrovírus
antiviral 	remédios para tratar doenças causadas por vários tipos de vírus
anvisa 	órgão do governo brasileiro que controla a produção, distribuição e venda de produtos e serviços envolvendo alimentos e remédios
anvisa 	órgão do governo brasileiro que controla a produção, distribuição e venda de produtos e serviços envolvendo alimentos e remédios
arritmia 	palpitação; o coração bate num ritmo diferente do normal
asma 	doença nos pulmões que faz com que os brônquios (tubos que ligam a traqueia aos pulmões) se fechem por estarem inflamados, fazendo com que a pessoa fique com um chiado e aperto no peito, falta de ar e tosse seca
aspiração traqueal 	retirada de secreções da traqueia (tubo abaixo da garganta, caminho para o pulmão) e dos brônquios (tubos que ligam a traqueia aos pulmões) feita com uma sonda introduzida na boca, no nariz ou em uma abertura feita na própria traqueia
aspiração endotraqueal 	retirada das secreções da traqueia (tubo abaixo da garganta, caminho para o pulmão) e dos brônquios (tubos que ligam a traqueia aos pulmões) feita com uma sonda introduzida na boca, no nariz ou em uma abertura feita na própria traqueia
assintomático 	pessoa sem sintomas
atazanar 	remédio para tratar HIV que está sendo testado no tratamento da Covid-19, doença causada pelo novo coronavírus (SARS-CoV-2)
atividade bactericida 	capacidade de matar bactérias
atividades essencial 	atividades importantes para o funcionamento do país, como serviços de atendimento à saúde, transporte público, abastecimento das cidades (comida, água, remédios, gasolina), entre outros.
atividades não essencial 	atividades que não interferem diretamente no funcionamento do país, como restaurantes, lojas de roupas, cinemas, salões de beleza etc.
autoisolamento 	quando alguém doente decide, por vontade própria, ficar separado daqueles que estão saudáveis para não contaminar outras pessoas 
autoquarentena 	quando a pessoa, mesmo que aparentemente saudável, se isola em sua própria casa, quarto de hotel ou outro local apropriado, por um período de tempo, para ter certeza de que não vai contaminar outras pessoas; o período de quarentena é normalmente de 14 dias
azitromicina 	remédio antibiótico usado no tratamento de várias doenças causadas por bactérias; tem sido testado no tratamento da Covid-19, doença causada pelo novo coronavírus (SARS-CoV-2)
bactéria 	organismo muito pequeno e simples que pode ser encontrado em todos os lugares. As bactérias são causadoras de muitas doenças, como alguns tipos de pneumonias, mas também podem ser muito importantes para os seres humanos e têm várias funções no nosso organismo, como proteger o intestino.
batimento de o asa de o nariz 	movimento de abertura forçada das narinas, sinalizando que a pessoa está fazendo muito esforço para respirar 
bloqueio total 	medida de isolamento que impede que as pessoas saiam de casa, por um determinado período de tempo, a não ser para atividades essenciais, como comprar comida e remédios e trabalhar em alguns casos
brônquio 	tubo que liga a traqueia aos pulmões e por onde o ar que respiramos passa
brônquios 	tubos que ligam a traqueia aos pulmões e por onde o ar que respiramos passa
cardiopatia 	doenças que afetam o coração
carga viral 	quantidade de vírus no sangue; nome de exame que mostra quantidade de vírus no sangue.
casar fatality ratio 	medida em que se divide o número de mortes pelo número total de pacientes diagnosticados como uma doença
caso confirmar 	pessoas que tiverem, com um teste, confirmação da presença do vírus no seu organismo, apresentando sintomas da doença ou não
caso suspeito 	pessoas que apresentam sintomas, mas que ainda não receberam a confirmação de teste sobre a presença do vírus no organismo, ou pessoas que entraram em contato com outras pessoas com coronavírus e/ou viajaram recentemente para países com muitos casos da doença 
cdc 	órgão do governo americano que trabalha na prevenção, controle e proteção contra doenças da população
célula 	menores unidades vivas com formas e funções definidas; existem organismos unicelulares (uma única célula), como as bactérias, e pluricelulares (com muitas células), como o ser humano. Os vírus são acelulares (não têm células), por isso não são considerados seres vivos. 
célula hospedeiro 	célula infectada por um vírus ou bactéria. Os vírus "comandam" a célula hospedeira e a usam para produzir mais vírus, reprogramando as células do hospedeiro (animal ou planta), que se torna uma "fábrica" de vírus
células t 	células do sistema de defesa do nosso corpo capazes de "limpar" a infeção do nosso organismo
cepa 	variedade de uma mesma espécie de vírus ou bactéria. O novo coronavírus (SARS-CoV-2) faz parte de uma nova cepa (família) de coronavírus que ainda não havia sido identificado em humanos.
cfr 	medida em que se divide o número de mortes pelo número total de pacientes diagnosticados como uma doença
choque séptico 	quando a pressão arterial do paciente fica perigosamente baixa e os órgãos entram em falência devido a uma infecção generalizada no corpo
cianose 	quando a pele, unhas ou boca ficam com color azulada. Pode ser sintoma de falta de oxigenação e de problema de circulação do sangue
ciclo de vida viral 	tempo de vida do vírus; quanto tempo ele sobrevive dentro de um organismo vivo 
cirurgia eletiva 	cirurgias ou procedimentos que não são considerados urgentes ou essenciais 
cloroquina 	remédio utilizado no tratamento da malária e em pacientes com doenças autoimunes, como o lúpus; está sendo testada no tratamento da Covid-19, doença causada pelo novo coronavírus (SARS-CoV-2)
coagulação 	processo que garante que a pessoa não perca muito sangue; nesse processo, o sangue perde suas características líquidas e se transforma em uma massa quase sólida, chamada coágulo
coágulo 	forma sólida do sangue; o sangue perde suas características líquidas e se transforma em uma espécie de massa de sangue
código genético 	instruções em um gene que dizem para a célula como produzir uma proteína específica
coinfecção 	quando o hospedeiro (planta ou animal) é infectado por dois ou mais tipos de vírus, bactérias etc.
comorbidade 	quando a pessoa tem duas ou mais doenças e uma doença pode deixar a outra mais grave
confinamento social 	medida de prevenção de doenças que reduz o contato entre pessoas e interrompe a maioria das atividades por um curto período. As pessoas evitam sair de casa. Só acontecem saídas para coisas essenciais como comprar comida, remédios e alguns tipos de trabalho
congestão nasal 	nariz entupido
consentimento informar 	documento que informa o paciente e/ou seus familiares/responsáveis sobre todas as consequências e riscos envolvidos em um procedimento médico
contágio 	passagem de uma doença de uma pessoa doente para uma pessoa saudável; acontece por contato indireto ou direto entre as pessoas 
contato próximo 	quando se fica perto de uma pessoa que tem uma doença
contenção comunitária 	modo de prevenir doenças pela diminuição do contato entre pessoas de uma comunidade, interrompendo a maioria das atividades por um período curto. As pessoas evitam sair de casa. Somente são permitidas saídas para atividades essenciais como comprar comida ou remédios e alguns tipos de trabalho
coriza 	secreção das fossas nasais; nariz escorrendo
coronavírus 	família de vírus capaz de causar doenças em humanos e animais; o SARS-CoV-2, que causa a doença Covid-19, é chamado de novo coronavírus porque é diferente dos outros coronavírus que existiam até agora
corpo estranho 	todo material encontrado no corpo e que normalmente ali não deveria estar; os vírus são considerados corpos estranhos
covid 19 	nome da doença causada pelo novo coronavírus (SARS-Cov-2); a sigla vem da expressão em inglês “Coronavirus Disease 2019”
crescimento exponencial 	quando algo aumenta muito rápido em pouco tempo
cti 	Centro de Terapia Intensiva: estrutura hospitalar equipada com um sistema que monitora o paciente 24h por dia e onde são admitidos pacientes em estado grave
curva de contágio 	velocidade com que uma doença se espalha em um determinado período de tempo: dias, semanas ou meses
curva epidêmica 	velocidade com que uma doença se espalha em um determinado período de tempo: dias, semanas ou meses
desidratação 	quando a quantidade de líquidos, como água e sais minerais, no corpo cai abaixo no nível necessário para o organismo funcionar bem; febre alta pode causar desidratação
dexametasona 	medicamento usado em doenças alérgicas, em teste para tratar pessoas com Covid-19 que precisam receber oxigênio
diabetes 	doença que ocorre quando o nosso corpo não consegue usar a glicose (tipo de açúcar) normalmente 
diagnóstico clínico 	definição de uma doença pelos sinais e sintomas
diagnóstico diferencial 	definição do tipo de doença feita por exclusão, processo de eliminação de outras doenças
diagnóstico laboratorial 	definição da condição do paciente ou da doença com o auxílio de exame ou teste feito em laboratório
diarreia 	quando as fezes estão muito frequentes, moles ou líquidas; normalmente ocorre por infecção no intestino causada por vírus, bactérias ou parasitas
disgeusia 	perda do paladar; perda da capacidade de sentir gostos
dispneia 	respiração difícil ou dolorosa; dificuldade para respirar
distanciamento físico 	distância física entre pessoas; para que doenças transmitidas por gotículas de saliva não sejam passadas de pessoa para pessoa, recomenda-se que seja mantida uma distância de pelo menos 2 metros entre cada pessoa.
distanciamento social 	medidas para reduzir o contato entre as pessoas e impedir que uma doença se espalhe muito rapidamente; exemplo: fechamento de bares e restaurantes, de escolas e o trabalho em casa - "home office" 
dna 	conjunto de moléculas que carrega a informação genética de todos os seres vivos (características da espécie e do indivíduo); genes em sequência
doença autoimune 	doença em que o sistema de defesa do nosso corpo ataca células saudáveis do próprio corpo
doença infectocontagiosa 	doença de transmissão rápida e fácil provocada por micro-organismos como vírus ou bactérias
doença crônica 	doença que dura muito tempo, piora aos poucos e que nunca é curada totalmente, exigindo que a pessoa use remédios sempre
doença endêmica 	doença que ocorre com frequência em determinadas regiões. Uma doença endêmica é aquela presente em uma área permanentemente, o tempo todo, durante anos e anos. Exemplo: a dengue no Brasil
doença infeccioso 	doença de transmissão rápida e fácil provocada por micro-organismos como vírus ou bactérias
doença pulmonar 	conjunto de doenças que afetam os pulmões
doença renal crônica 	doença que afeta os rins, fazendo com que eles parem de funcionar de forma lenta e gradual
doença respiratória 	doença que afeta o sistema respiratório da pessoa e a sua capacidade de respirar
doença viral 	doença causada por um vírus, como sarampo, caxumba, Covid-19, etc.
doente crônicos 	pacientes que possuem doenças sem cura e de longa duração, como diabéticos, hipertensos 
dor muscular 	dores no corpo; podem ser sintoma da Covid-19
edema pulmonar 	doença causada por excesso de líquido nos pulmões
efeito adverso 	qualquer efeito indesejado de um remédio
eficácia de o vacina 	medida que confirmar se uma vacina teve efeito desejado e conseguiu proteger contra uma doença
elisa 	tipo de teste para a Covid-19, que detecta se a pessoa teve ou não contato com o vírus; teste baseado nas reações entre o antígeno (parte do vírus detectada pelo nosso corpo) e os nossos anticorpos (defesas do nosso organismo)
endemia 	quando doenças ou agentes infecciosos, como vírus e bactérias, aparecem com frequência em determinadas regiões. Uma doença é endêmica quando acontece sempre em uma área, durante anos e anos, como é a dengue no Brasil. 
enfermidade 	doença
entubar 	colocar tubo ou sonda em um paciente; também escrito "intubar"
epi 	Equipamento de Proteção Individual - equipamentos para proteção do corpo contra riscos que podem causar doenças ou ferimentos
epidemia 	quando uma doença tem um aumento muito grande de casos durante um tempo, mas depois o número de casos cai. No inverno, epidemias de gripe são frequentes.
epidemiologia 	estudo sobre como doenças infecciosas, causadas por vírus, bactérias, protozoários, etc., se comportam em uma determinada região em grupos de pessoas, e sobre como controlar essas doenças  
epidemiológico 	relacionado à epidemiologia e epidemia (*Ver Epidemiologia e epidemia no glossário)
epidemiologista 	profissional da saúde e de outras áreas que estuda fenômenos e comportamento das doenças e da saúde na população
equipamento de proteção individual 	EPI - equipamentos para proteção do corpo contra riscos que podem causar doenças ou ferimentos
escarro 	catarro persistente na garganta, que normalmente causa tosse
estado de calamidade pública 	quando a cidade, estado ou país está passando por situações que causam sérios danos à saúde e aos serviços públicos e o "estado de calamidade pública" é declarado oficialmente pelos governos. Assim, governos podem obter e gastar dinheiro de forma mais facilitada 
exame laboratorial 	exame feito em lugar especialmente equipado para verificar doenças 
extubação 	remoção de tubo colocado para ajudar um paciente a respirar
extubar 	retirar tubo ou sonda
face shield 	proteção para o todo o rosto feita de plástico duro e transparente
fadiga 	cansaço, exaustão
faixa etária 	intervalo por idades; divisão da população ou de um grupo de pessoas pela idade
falência múltipla de o órgãos 	quando dois ou mais órgãos do nosso corpo ficam com suas funções comprometidas e param de funcionar
falso negativo 	quando o resultado de um teste é negativo, mas a pessoa que está sim infectada com o vírus
falso positivo 	quando o resultado de um teste é positivo, mas pessoa não está infectada com o vírus
fase agudo de o doença 	fase da doença que surge após a infecção e quando os sintomas (febre alta etc.), normalmente, são mais fáceis de serem percebidos
fator de risco 	qualquer situação que aumente as chances de uma pessoa ficar doente ou de piorar de uma doença
febril 	pessoa com febre
fômite 	qualquer objeto que transporta micro-organismos, como vírus e bactérias, que podem causar infecção; exemplos: roupas que a pessoa está vestindo, a maçaneta de uma porta, embalagens de comida, entre outros 
fonte de infecção 	objeto, planta, animal ou pessoa contaminada com vírus, bactérias etc. e que transmitiu a doença para outro hospedeiro
frequência cardíaca 	número de batimentos do coração por minuto
frequência respiratória 	número de vezes que puxamos e soltamos o ar por minuto
funções essencial de o governo 	todos os serviços necessários para que o governo possa continuar cuidando das necessidades básicas da população, como saúde, segurança e bem-estar 
gastroenterite 	inflamação do revestimento do estômago e dos intestinos; pode ser causada por remédios ou outras substâncias e também por vírus, bactéria ou outro parasita; principais sintomas: enjoo, vômito e diarreia
gene 	estruturas que contêm informações sobre as nossas características; a pessoa pode ter um gene que determina que a cor dos seus olhos é azul, ou castanha etc.
genoma 	conjunto de genes de uma célula ou organismo vivo; uma célula humana contém dois genomas, um da mãe e outro do pai
germe 	micro-organismos, como vírus, bactérias, fungos e protozoários que podem causar doenças
glicemia 	açúcar no sangue
glóbulos branco 	células do sangue que defendem o organismo contra doenças como infecções, alergias, resfriados e gripes; o mesmo que "leucócitos"
glóbulos vermelho 	células do sangue importantes para levar oxigênio aos tecidos do corpo; também são responsáveis pela cor vermelha do sangue
gotículas respiratória 	gotinhas muito pequenas produzidas pelo nosso organismo e que escapam da nossa boca quando falamos ou tossimos e do nosso nariz quando espirramos
gripe 	doença causada pelo vírus influenza e que afeta o sistema respiratório da pessoa, normalmente atacando o nariz, a garganta e podendo chegar aos pulmões
gripe espanhol 	nome de uma pandemia de gripe que aconteceu entre 1918 e 1919 e atingiu todo o mundo, deixando pelo menos 50 milhões de mortos
gripe sazonal 	nome dado à gripe que ocorre no período mais frio do ano; no Brasil, a gripe sazonal acontece geralmente de abril a outubro
grupo de controlo 	grupo de pessoas que não será testado ou receberá o remédio em um experimento ou estudo sobre uma doença; esse grupo toma o que chamamos de placebo (substância neutra, sem os efeitos do remédio de verdade)
grupo de risco 	pessoas com maior chance de terem quadros graves da doença, como idosos, mulheres grávidas e bebês recém-nascidos, além de pessoas com outras doenças, como diabetes, pressão alta, câncer, entre outras
grupo vulnerável 	pessoas com maior chance de terem quadros graves da doença, como idosos, mulheres grávidas e bebês recém-nascidos, além de pessoas com outras doenças, como diabetes, pressão alta, câncer, entre outras
habilitar leito 	preparar leitos, como todos os equipamentos necessários, para que possam receber pacientes
hidroxicloroquina 	remédio utilizado no tratamento da malária e em pacientes com doenças autoimunes, como o lúpus; está sendo testada no tratamento da Covid-19, doença causada pelo novo coronavírus (SARS-CoV-2)
higiene de o mãos 	forma de prevenir o contágio de uma doença, como a Covid-19, por meio da lavagem frequente das mãos ou do uso de álcool em gel 70%
hipertensão 	pressão alta;  quando o sangue faz muita pressão contra os vasos sanguíneos, que transportam sangue do coração para todas as partes do nosso corpo
hipertenso 	pessoa com pressão alta
hiperventilação 	ventilação dos pulmões além das necessidades normais do corpo
hiposmia 	perda do olfato, capacidade de sentir cheiros
hipóxia 	falta de oxigênio suficiente no sangue para que o nosso corpo continue funcionando bem
hospedeiro 	organismo simples ou complexo, incluindo o homem, que é capaz de ser infectado por um agente específico, como vírus ou bactéria, entre outros
hospital de campanha 	hospital temporário construído para atender pacientes em uma situação de emergência, como a pandemia do novo coronavírus; durante a pandemia, essas unidades atendem somente pacientes em estado médio e grave da doença 
idiopático 	sem causa conhecida
imune 	estar livre ou protegido de uma doença ou condição
imunidade 	sistema de defesa do organismo; capacidade do corpo de se defender contra doenças causadas por determinadas bactérias, vírus e outros micro-organismos
imunidade adquirir 	defesas que o nosso corpo vai ganhando com o tempo e com a exposição a diferentes patógenos, como vírus, bactérias etc., presentes no meio ambiente 
imunidade coletiva 	resistência de um grupo de pessoas, ou de toda a população de um país, à uma doença, por meio da vacinação da maior parte da população; ou quando um grande número de pessoas já contraiu a doença e ficou imune, diminuindo ou acabando com a circulação do vírus, bactéria etc. 
imunidade cruzar 	quando a pessoa já teve uma doença da mesma família de vírus e criou defesas que podem ajudar a combater doenças causadas por outros vírus dessa mesma família
imunidade de rebanho 	resistência de um grupo de pessoas, ou de toda a população de um país, à uma doença, por meio da vacinação da maior parte da população; ou quando um grande número de pessoas já teve a doença e ficou imune, diminuindo ou acabando com a circulação do vírus, bactéria etc. 
imunidade inato 	imunidade que nasce com a pessoa e não precisa ser aprendida através da exposição de um invasor, como vírus, bactérias etc.
imunização 	ação para tornar uma pessoa resistente a uma doença; meio de promover proteção específica contra a maioria das doenças que conhecemos causadas por vírus, bactérias etc. e que fazem mal à nossa saúde
imunização ativa 	quando vacinas são utilizadas para estimular os mecanismos naturais de defesa do nosso corpo (*Ver vacina no glossário)
imunização passivo 	imunização que pode ocorrer de forma natural ou artificial; de forma natural quando, por exemplo, a mãe transfere imunidade para o feto e de forma artificial por injeção de substâncias chamadas globulinas imunes, de outras pessoas ou animais já imunizados (com defesas contra determinada infecção)   
imunizar 	livre ou protegido de uma doença ou condição
imunizante 	vacina ou soro com anticorpos de pessoas que já tiveram a doença
imunocompetente 	pessoa que tem um sistema de defesa do organismo funcionando bem, sendo capaz de reagir e combater doenças causadas por vírus, bactérias e outros micro-organismos 
imunir 	pessoa que tem seus mecanismos normais de defesa do organismo contra infecções prejudicados por diferentes razões, como transplante de um órgão, queimaduras graves e doenças como câncer e HIV, entre outras
imunodeficiência 	condição em que as defesas do organismo da pessoa não funcionam bem, levando a infecções mais frequentes que o normal e que normalmente são mais graves e duram mais tempo
imunoglobulina 	proteína que tem como principal função a defesa do organismo; o mesmo que "anticorpos"
in vitro 	expressão em Latim que significa coisas que acontecem fora dos sistemas vivos, ou seja, em um ambiente controlado, como um tubo de vidro, em um laboratório
incidência 	número de casos confirmados de uma doença por milhão de habitantes em um tempo específico (1mês, 1 ano etc.)
incubação 	tempo entre ser infectado por uma doença e começar a apresentar os primeiros sintomas
infecção 	entrada e desenvolvimento de um agente infeccioso, como vírus, bactérias etc. no organismo ou a multiplicação de um desses vírus ou bactérias já existentes
infecção de via aérea 	infecção que surge em qualquer órgãos envolvido na respiração, como o nariz, a garganta ou ossos da face, até os brônquios e pulmões
infecção endêmica 	quando uma doença está presente em uma área/região sempre, o tempo todo, durante anos e anos, como a dengue no Brasil
infecção respiratória 	infecção que surge em qualquer órgãos envolvido na respiração, como o nariz, a garganta ou ossos da face, até os brônquios e pulmões
infecção viral 	doenças causadas por vírus; existem vários tipos de infecções virais, como sarampo, gripe, hepatite e a covid-19 (causada pelo novo coronavírus)
infeccioso 	que causa ou que resulta de infecção
infectante 	aquele que pode causar uma infecção; aplica-se, geralmente, ao parasita 
infectologista 	médico especialista no diagnóstico, tratamento e prevenção de doenças causadas por vírus, bactérias, fungos e parasitas
influenza 	vírus que causa gripe por meio de infecção no sistema respiratório da pessoa, normalmente afetando o nariz, a garganta e podendo chegar aos pulmões
insuficiência cardíaca 	condição na qual o coração é incapaz de bombear a quantidade de sangue necessária para o corpo
insuficiência pulmonar 	condição na qual o nível de oxigênio no sangue fica perigosamente baixo ou o nível de dióxido de carbono (CO2) no sangue fica perigosamente alto, causando dificuldade para respirar, entre outros problemas
insuficiência respiratória 	condição na qual o nível de oxigênio no sangue fica perigosamente baixo ou o nível de dióxido de carbono (CO2) no sangue fica perigosamente alto, causando dificuldade para respirar, entre outros problemas
insumo 	matérias-primas necessárias para a fabricação e realização de testes para doenças
insumo para teste 	matérias-primas necessárias para a fabricação e realização de testes para doenças
intensivista 	médico especializado no atendimento a pacientes em estado grave; normalmente, esses pacientes estão internados em UTI
interferon 	remédio usado para tratar hepatite e outras doenças e que vem sendo testado no tratamento da Covid-19, doença causada pelo novo coronavírus (SARS-Cov-2)
internação hospitalar 	pacientes que são admitidos para ocupar um leito hospitalar por um período igual ou superior a 24 horas
intraçar 	dentro da célula
intranasal 	na cavidade nasal; dentro do nariz
intravenoso 	injeção por agulha ou cateter dentro das veias; o mesmo que endovenoso
intubação 	procedimento em que se introduz um tubo na traqueia (tubo abaixo da garganta/caminho para o pulmão) para ajudar e manter a respiração do paciente
intubar 	colocar tubo ou sonda em um paciente; também escrito "entubar"
isolamento 	medida de prevenção contra a Covid-19, que afasta pessoas doentes ou contaminadas pelo vírus, mesmo que não apresentem sintomas, de pessoas não afetadas pelo novo coronavírus (SARS-CoV-2), evitando que o vírus se espalhe e contamine outras pessoas
isolamento domiciliar 	pacientes que apresentam sintomas leves e foram diagnosticados com Covid-19, doença causada pelo novo coronavírus (SARS-Cov-2), e que permanecem em casa, isoladas, até a recuperação
isolamento físico 	distanciamento físico entre as pessoas; manter uma distância de pelo menos 2 metros para não contaminar o outro com a doença
isolamento horizontal 	medida de prevenção contra a Covid-19, que afasta pessoas doentes ou contaminadas pelo vírus, mesmo que não apresentem sintomas, das pessoas não afetadas pelo novo coronavírus (SARS-CoV-2), evitando que o vírus se espalhe e contamine outras pessoas
isolamento social 	medida de prevenção contra a Covid-19, que afasta pessoas doentes ou contaminadas pelo vírus, mesmo que não apresentem sintomas, de pessoas não afetadas pelo novo coronavírus (SARS-CoV-2), evitando que o vírus se espalhe e contamine outras pessoas
isolamento vertical 	medida de prevenção contra a Covid-19, na qual somente as pessoas acima de 60 anos seriam isoladas e deveriam permanecer em casa
janela imunológica 	período entre o contato com o agente infeccioso, vírus, bactéria etc., e o tempo que o organismo leva para produzir quantidade suficiente de defesas (anticorpos) contra a infecção capazes de serem identificadas nos exames de laboratório
laringe 	órgão localizado na região da garganta, entre a traqueia e a base da língua, que ajuda na respiração e produz sons
lesão 	ferimento, machucado
letalidade 	capacidade ou potencial da doença para provocar mortes
leucócitos 	células do sangue que defendem o organismo contra doenças como infecções, alergias, resfriados e gripes; o mesmo que "glóbulos brancos"
linfócitos 	tipo de célula de defesa imediata do organismo, atuando contra células cancerígenas e infecções causadas por vírus; fazem parte dos glóbulos brancos
linfócitos t 	células do sistema de defesa do nosso corpo capazes de limpar a infeção do organismo
lockdown 	medida de isolamento que impede que as pessoas saiam de casa, por um determinado período de tempo, a não ser para atividades essenciais como comprar comida e remédios e trabalhar em alguns casos
malária 	doença causada por um parasita chamado Plasmodium, transmitido pela picada de mosquitos infectados
manobra de prona 	quando o paciente é colocado de barriga para baixo para melhorar a circulação de oxigênio nos tecidos e a respiração 
máscara caseiro 	máscara não médica, que pode ser feita em casa, lavável e de uso individual; deve ser feita com pelo menos duas camadas de tecido
máscara cirúrgica 	máscara utilizada por médicos e outros profissionais de saúde durante cirurgias e outros procedimentos 
medicamento 	remédio
mers 	infecção por um tipo de coronavírus com sintomas parecidos aos da gripe; foi identificada, pela primeira vez, no Oriente Médio, em 2012 e causou um grande número de mortes
ministério de o saúde 	órgão do governo federal que organiza e elabora planos e políticas públicas voltados para a promoção, prevenção e assistência à saúde dos brasileiros
morbidade 	número de pessoas que possuem uma doença em relação ao número de habitantes de um determinado local
mortalidade 	número de mortes por uma determinada doença em uma população 
mutação de um vírus 	mudança nas características de um vírus
neutrófilos 	células do sangue que são as principais responsáveis pela defesa contra bactérias e fungos
obesidade 	peso acima do normal
óbito 	morte
olfato 	capacidade de sentir cheiros; a pessoa com coronavírus pode perder ou ter o olfato reduzido
oms 	Organização Mundial  da Saúde, agência internacional que que orienta os cuidados com a saúde no mundo todo, incentiva a cooperação entre os países e coordena respostas a emergências, como na pandemia do novo coronavírus
oxímetro 	aparelho que se encosta ou prende no corpo da pessoa para medir a quantidade de oxigênio que o seu sangue está transportando
paciente assintomático 	pessoa que não apresenta sinais ou sintomas de doença 
paciente zero 	primeira pessoa a contrair uma doença causada por vírus ou bactéria
pandemia 	quando uma doença se espalha para vários países, em dois ou mais continentes, como aconteceu com o novo coronavírus (SARS-CoV-2)
parada cardiorrespiratória 	quando o coração para de bater de repente, prejudicando também a respiração e fazendo com que a pessoa desmaie; o mesmo que "parada cardíaca" 
parada respiratória 	quando a pessoa para de respirar de uma hora para outra e com isso os tecidos do corpo ficam sem oxigênio, principalmente órgãos como o cérebro e o coração
parainfluenza 	grupo de vírus que causa muitas doenças respiratórias, como resfriados comuns, gripes e pneumonia
parasita 	organismo que vive sobre ou dentro de outro organismo vivo, causando dano e não oferecendo nenhum benefício
patogênese 	origem das doenças; aquilo que causa a doença; o mesmo que "patogenia"
patogênese viral 	mecanismo pelo qual um vírus produz doenças em seus hospedeiros ou destrói células para produzir sinais e sintomas da doença
patogenia 	origem das doenças; aquilo que causa a doença; o mesmo que "patogênese"
patogênico 	que causa doença
patógeno 	micro-organismos, como bactérias, vírus, fungos etc. que causam doenças se conseguirem entrar no corpo do hospedeiro (pessoa, animal)
patologia 	área da medicina e da biologia que estuda as doenças e o que elas causam no organismo
pcr rt 	tipo de teste para confirmar se a pessoa está infectada com o novo coronavírus; feito com coleta de secreção da garganta e do nariz da pessoa com uma espécie de cotonete (chamado "swab") 
teste pcr rt 	tipo de teste para confirmar se a pessoa está infectada com o novo coronavírus; feito com coleta de secreção da garganta e do nariz da pessoa com uma espécie de cotonete (chamado "swab")
perda de o paladar 	quando a pessoa deixa de sentir o gosto dos alimentos; pode ser um dos sintomas da Covid-19
perdigoto 	gotinhas muito pequenas de saliva que a pessoa libera no ar quando espirra ou tosse
período de incubação 	tempo entre ser infectado por uma doença e começar a apresentar os primeiros sintomas
plano de contingência 	documento que tem um plano de ação feito por governos municipais, estaduais e federal para combater desastres ou epidemias, como a do coronavírus
plaqueta 	pequenos fragmentos de célula presentes no sangue e produzidos pela medula óssea; são responsáveis pelo processo de coagulação, que garante que a pessoa não perca muito sangue (*ver coagulação no glossário)
plasma sanguíneo 	parte líquida do sangue; é um fluido amarelado que tem nutrientes, proteínas, hormônios e resíduos, guarda os anticorpos gerados quando a pessoa se cura de uma infecção
plasma convalescente 	tratamento sendo testado com a Covid-19, que envolve a transfusão do plasma de sangue de um paciente curado para uma pessoa infectada com o vírus. O plasma da pessoa curada possui anticorpos (defesas) para a doença e esses anticorpos seriam transferidos para o doente, ajudando na aceleração da cura.
pleura 	estrutura, como uma capa fina, que envolve e protege o pulmão
pneumonia 	infecção nos pulmões causada por vírus, bactérias, fungos e outros parasitas; ocorre quando os sacos de ar dos pulmões (chamados de alvéolos) se enchem de pus ou outros líquidos, e isso dificulta para o oxigênio chegar ao sangue 
pneumonia bacteriano 	infecção nos pulmões causada por bactéria
pneumonia viral 	infecção nos pulmões causada por vírus
posição prono 	de barriga para baixo
posição supino 	de barriga para cima
prevalência 	número total de casos de uma doença, novos e antigos, existentes num determinado local e período
profilaxia 	conjunto de medidas para prevenir doenças ou reduzir suas complicações e consequências
profilático 	relacionado à profilaxia (*Ver profilaxia no glossário)
propagação de o doença 	forma como uma doença se espalha em uma região
proteína ace2 	proteína presente no nosso corpo, principalmente nas células do coração e do sistema respiratório, considerada porta de entrada para a infecção causada pelo novo coronavírus (SARS-Cov-2)
quarentena 	isolamento de pessoas que parecem saudáveis, mas que podem ter sido expostas a uma doença, como a Covid-19, por um período determinado, normalmente 14 dias
quarto de isolamento com pressão negativo 	quartos que não permitem que o ar circule de dentro para fora, usados para isolar pacientes com doenças contagiosas 
radiografia de tórax 	exame de imagem da região do tórax (peito), pelo qual o médico consegue ver os pulmões, coração e costelas e investigar possíveis doenças
raio x de tórax 	exame de imagem da região do tórax (peito), pelo qual o médico consegue ver os pulmões, coração e costelas e investigar possíveis doenças
rastreamento de contatos 	processo de identificar, avaliar e gerenciar pessoas que tenham sido expostas a doenças contagiosas para evitar que a doença seja transmitida para outras pessoas
reagente 	substância que se transforma em outra por conta de uma reação química; os reagente são muito utilizados em testes para doenças
remdesivir 	remédio usado para tratar doenças causadas por vírus e que está sendo testado como tratamento da Covid-19, doença causada pelo novo coronavírus SARS-CoV-2
replicação viral 	processo pelo qual um vírus se reproduz e se multiplica dentro de um organismo vivo
resfriar 	doença respiratória causada por diferentes vírus, como o rinovírus ou alguns tipos de coronavírus 
respirador n95 	equipamento de proteção individual (EPI), parece uma máscara e é usado por quem trabalham em ambientes contaminados, como hospitais, fábricas etc.
resposta imune 	mecanismo de defesa do organismo, quando o nosso corpo reconhece um invasor, como vírus ou bactérias, e passa a produzir anticorpos (defesas)
ritonavir 	remédio usado no tratamento do HIV, que está sendo testado no tratamento da Covid-19, doença causada pelo novo coronavírus SARS-CoV-2
retrovírus 	grupo de vírus que possui um único tipo de material genético, o RNA; o HIV, que pode causar AIDS, é um retrovírus 
rinovírus 	vírus que causa o resfriado comum
rna 	conjunto de moléculas responsável por produzir proteínas; muitos vírus possuem RNA e não DNA, como é o caso do novo coronavírus SARS-CoV-2
r0 	medida da velocidade com que um vírus se reproduz
sars 	infecção por um tipo de coronavírus com sintomas parecidos aos da gripe; foi identificado pela primeira vez na China em 2002 e desde 2004 não foram detectados novos casos
sars cov 	identificado em 2002 como a causa de um surto de síndrome respiratória aguda grave (SARS); é diferente do SARS-CoV-2, que é o novo coronavírus responsável pela pandemia de 2019/2020 
sars cov 2 	novo coronavírus que causa doença respiratória infecciosa, identificado na China, no fim de 2019
saturação de oxigênio 	nível de oxigênio medido com aparelho; quando a saturação de oxigênio está baixa a pessoa sente falta de ar e pode desmaiar
sdra 	dificuldade respiratória causada por diversas doenças; os pulmões ficam cheios de líquido e os níveis de oxigênio no sangue são reduzidos. A pessoa sente falta de ar, a pele pode ficar azulada e o coração e o cérebro podem apresentar mau funcionamento
sedentarismo 	situação em que a pessoa não pratica qualquer tipo de atividade física regularmente, além de permanecer muito tempo sentada e não ter disposição para realizar atividades simples do dia a dia, o que pode afetar a saúde e o bem-estar da pessoa
sepse 	quando substâncias químicas liberadas na corrente sanguínea para combater uma infecção desencadeiam uma inflamação em todo o corpo
serviços essencial 	serviços considerados importantes para o funcionamento do país, como os serviços de atendimento à saúde, transporte público, serviços relacionados ao abastecimento das cidades (comida, remédios etc.), entre outros
serviços não essencial 	serviços que não interferem diretamente no funcionamento do país, como restaurantes e lojas de roupas, cinemas, salões de beleza etc.
sinal de um doença 	o que a pessoa demonstra quando está doente
sinal vital 	medidas básicas do funcionamento corpo de um ser humano, essenciais para que ele esteja bem; são elas: pressão arterial, pulso, respiração e temperatura
síndrome de o desconforto respiratório agudo 	dificuldade respiratória causada por diversas doenças; os pulmões ficam cheios de líquido e os níveis de oxigênio no sangue são reduzidos. A pessoa sente falta de ar, a pele pode ficar azulada e o coração e o cérebro podem apresentar mau funcionamento
síndrome gripal 	doença parecida com gripe, que pode ter diferentes causas: infecção pelo vírus influenza, parainfluenza, adenovírus ou vírus sincicial respiratório; também pode ser causada por bactérias. Principais sintomas: febre alta, tosse, dor de garganta, dor de cabeça e dor no corpo, normalmente duram 1 semana
síndrome respiratória aguda grave 	infecção por um tipo de coronavírus com sintomas parecidos aos da gripe; foi identificado pela primeira vez na China em 2002 e desde 2004 não foram detectados novos casos
síndrome respiratória aguda grave por  o novo coronavírus 	infecção pelo novo coronavírus com sintomas principalmente respiratórios, como tosse e dificuldade para respirar, mas que pode causar outros sintomas como perda da capacidade de sentir cheiros e gostos, entre outros
síndrome respiratória de o oriente médio 	infecção por um tipo de coronavírus com sintomas parecidos aos da gripe; foi identificada, pela primeira vez, no Oriente Médio, em 2012 e causou um grande número de mortes
sintomático 	pessoa que apresenta sintomas da doença
sintoma 	sinais de doença; o que a pessoa sente quando está doente 
sistema imune 	sistema que defende o nosso corpo contra infecções e outras doenças; ele é formado por vários órgãos, células e proteínas chamadas anticorpos. O sistema imune identifica, ataca e destrói germes e outras substâncias que tentam atacar o nosso corpo.
sistema imunológico 	sietema que defende o nosso corpo contra infecções e outras doenças; ele é formado por vários órgãos, células e proteínas chamadas anticorpos. O sistema imune identifica, ataca e destrói germes e outras sustâncias que tentam atacar o nosso corpo.
sistema respiratório 	conjunto de órgãos envolvidos na respiração, como nariz, faringe, laringe, traqueia, brônquios e pulmão
sorologia 	medida da quantidade de anticorpos presentes no soro (parte líquida do sangue) de uma pessoa que está ou esteve infectada com uma doença
subnotificação 	quando os casos notificados da doença ficam abaixo dos casos reais
supressão 	estratégia de bloquear imediatamente a circulação de um vírus na sociedade, paralisando o funcionamento normal da sociedade por alguns meses
suscetível 	qualidade da pessoa ou animal que não tem resistência contra o que pode causar doenças, como vírus, bactéria etc.
surto 	casos de uma determinada doença que surgem de repente em uma comunidade humana; pode ser em uma cidade ou em uma escola, hospital etc.
swab 	tipo de cotonete que coleta amostras de secreção de nariz e garganta para uso em exames
swab nasofaríngeo 	forma de coleta para alguns tipos de teste de confirmação de doenças; a coleta é feita com uma espécie de cotonete que retira amostras de secreção do nariz e/ou garganta da pessoa
tabagismo 	ato de fumar cigarros ou outros produtos que contenham tabaco
taxa de ataque 	número de pessoas afetadas por uma doença dividido pelo número de pessoas expostas ao agente causador da doença, como vírus ou bactéria, mas que não pegaram a doença
taxa de letalidade 	mede o poder da doença de causar mortes
taxa de mortalidade 	mede o risco que qualquer pessoa na população tem de morrer por causa de uma determinada doença
taxa de sobrevivência 	número de pessoas que conseguem sobreviver a uma doença
taxa de transmissão 	capacidade que um vírus tem de ser transmitido entre as pessoas; no caso do SARS-CoV-2, uma pessoa infectada pode transmitir o vírus para 2 a 3 pessoas
telemedicina 	atendimento médico a distância; quando médicos analisam exames ou receitam um remédio sem estar no mesmo local do paciente
temperatura corporal 	temperatura do corpo, que quando a pessoa não está doente varia entre 36º C e 36,7º C
terapia antiviral 	tratamento com remédios antivirais, que são remédios que tratam doenças causadas por vírus
testagem drive thru 	quando as pessoas são testadas para o novo coronavírus sem precisar sair do carro; o profissional de saúde coleta a secreção do nariz e/ou garganta da pessoa com uma espécie de cotonete 
teste rápido para coronavírus 	teste que detecta se a pessoa tem anticorpos (defesas) para o novo coronavírus; se der positivo, quer dizer que a pessoa já teve a doença 
teste molecular 	tipo de teste utilizado para confirmar se a pessoa está infectada com o novo coronavírus; esse teste procura traços de vírus nas secreções no nariz e da garganta da pessoa; o mesmo que teste RT-PCR
teste rt pcr 	tipo de teste utilizado para confirmar se a pessoa está infectada com o novo coronavírus; ele procura por traços de vírus nas secreções no nariz e da garganta da pessoa; o mesmo que "teste molecular"
teste sorológico 	teste que avalia se a pessoa tem anticorpos (defesas), mas não detecta a presença do vírus no organismo; deve ser feito pelo menos 10 dias após o aparecimento dos sintomas da doença; se der positivo, quer dizer que a pessoa já teve a doença
tiragem intercostal 	movimento de expansão forçada do tórax no qual aparecem as costelas; sinaliza que a pessoa precisa fazer muito esforço para respirar
tomografia de tórax 	exame de imagem de alta definição da região do tórax (peito), pelo qual o médico consegue ver os pulmões, coração e costelas e investigar possíveis doenças
tossir seca 	tosse com pouca secreção, sem catarro
transmissão comunitária 	quando há um aumento de casos da doença e as autoridades de saúde não conseguem mais encontrar a origem do que está causando a doença
transmissão local 	quando a pessoa infectada não esteve em outro país com registro da doença, mas teve contato com uma pessoa que pegou a doença em outro país
transmissão por gotículas 	modo de transmissão de uma doença que envolve gotas respiratórias, que deixamos escapar quando falamos, espirramos ou tossimos
transmissão sustentar 	quando há um aumento de casos da doença e as autoridades de saúde não conseguem mais encontrar a origem do que está causando a doença
transmissibilidade 	capacidade que um agente infeccioso, como vírus ou bactérias, tem de passar de um objeto, planta, animal ou pessoa, para um novo hospedeiro, que pode ser um animal ou pessoa
transmissível 	o que pode passa de pessoa para pessoa
traqueia 	órgão do sistema respiratório, que parece um tubo, e que filtra, umedece e conduz o ar que respiramos aos pulmões
trato gastrointestinal 	conjuntos de órgãos como boca, faringe, esôfago, intestino delgado, intestino grosso e ânus responsável por tirar dos alimentos que comemos os nutrientes necessários para as funções do organismo, como crescimento, energia, reprodução, entre outras
trato respiratório inferior 	conjunto de órgãos envolvidos na respiração, como brônquios e pulmões, e que ficam dentro do peito
trato respiratório superior 	conjunto de órgãos envolvidos na respiração, como nariz, faringe, laringe e parte superior da traqueia, e que ficam fora do peito
trato respiratório 	conjunto de órgãos envolvidos na respiração, como nariz, faringe, laringe, traqueia, brônquios e pulmão
triagem 	exame inicial; quando um paciente chega ao hospital, um profissional de saúde faz perguntas e procedimentos, como medir a temperatura, para determinar a gravidade do estado de saúde da pessoa e qual a sua prioridade de atendimento pelo médico 
tropismo viral 	tendência ou preferência que um vírus tem para infectar um determinado tipo de célula ou tecido em especial
unidade de terapia intensiva 	UTI - estrutura hospitalar equipada com sistema que monitora o paciente 24h por dia e que atende pacientes em estado grave
uti 	Unidade de Terapia Intensiva - estrutura hospitalar equipada com sistema que monitora o paciente 24h por dia e que atende pacientes em estado grave
vacina 	substâncias que preparam o corpo para combater uma doença; são feitas a partir de pequenos pedaços de bactérias ou vírus ou de organismos vivos inteiros, mas enfraquecidos, que não têm capacidade de causar doença, mas que ativam as defesas do corpo
vacinação 	proteção contra doenças por meio da introdução de micróbio morto ou enfraquecido para ativar a produção de anticorpos (defesas) nas pessoas
vacinação drive thru 	quando as pessoas recebem a vacina de dentro do carro, sem precisar ir até um posto de saúde
ventilação 	auxílio para a entrada de ar nos pulmões
ventilador mecânico 	aparelho que leva ar aos pulmões através de um tubo colocado na boca, no nariz ou através de uma abertura na traqueia
vetor 	vetores são os animais, como pulgas, mosquitos ou ratos, que hospedam e depois transmitem algumas doenças para as pessoas; o mosquito é o vetor da dengue, pois um parasita infecta o mosquito que picará uma pessoa, só então a dengue é passada para quem for picado pelo mosquito.
via aérea superior 	conjunto de órgãos envolvidos na respiração, como nariz, faringe, laringe e parte superior da traqueia, e que ficam localizados fora do peito
via aérea inferior 	conjunto de órgãos envolvidos na respiração, como brônquios e pulmões, e que ficam dentro do peito
vigilância epidemiológica 	ação para identificar e prevenir doenças transmissíveis e seus fatores de risco; faz estudos e normas para acompanhamento e prevenção de doenças, como registro e observação de casos suspeitos ou confirmados de doenças transmissíveis e dos contatos entre pessoas doentes
vínculo epidemiológico 	todo caso suspeito que teve contato com uma ou mais pessoas com a doença confirmada por teste
virulência 	capacidade de um vírus ou bactéria de se multiplicar dentro de um organismo e de causar efeitos graves
vírus 	micro-organismos acelulares (sem célula) que atacam as células de seus hospedeiros e provocam doenças; o novo coronavírus SARS-CoV-2 é um tipo de vírus que causa a doença Covid-19
wuhan 	cidade da China onde detectou-se o primeiro caso da Covid-19, doença causada pelo novo coronavírus SARS-CoV-2
zoonose 	doença que pode ser transmitida de pessoas para animais e de animais para pessoas