acinesia = paralisia; falta de movimento, ausência de movimento
alfa-sinucleína = proteína que mais se acumula no cérebro da pessoa com DP, destruindo células importantes
ativação muscular = uso de músculos
atividades de vida diária = atividades do dia a dia
AVDs = atividades do dia a dia
bradicinesia = diminuição e lentidão de movimentos
caminhada nórdica = tipo de caminhada em que a pessoa segura um bastão em cada mão e se apoia um pouco neles para andar
células nervosas = células do cérebro e da coluna que transmitem informações para todo o corpo
CM = local em que o peso do corpo fica concentrado
centro de massa = local em que o peso do corpo fica concentrado
CP = distância de dois passos
comprimento de passada = distância de dois passos
controle motor  = controle dos movimentos
Corpos de Lewy = agrupamento anormal de proteínas dentro de células nervosas
crônica = doença sem cura e que exige uso contínuo de medicação
desordem neurológica = doença que atinge o sistema nervoso
doença crônica = doença sem cura e que exige uso contínuo de medicação
doença degenerativa = doença que vai piorando a situação da pessoa aos poucos
dopamina = hormônio importante para o funcionamento do cérebro 
estabilidade dinâmica = equilíbrio ao se movimentar
estabilidade estática = equilíbrio ao ficar parado
festinação = aceleração não controlada dos passos da pessoa com DP para não cair para frente
fisiopatologia = funcionamento da doença
fisioterapia = técnicas guiadas por um profissional usadas no tratamento de problemas com os movimentos do corpo
fonoaudiologia = técnicas guiadas por um profissional usadas para tratar problemas de fala
freezing = congelamento da caminhada, como se a pessoa estivesse colada ao chão
FP = velocidade com que se dá os passos
frequência de passada = velocidade com que se dá os passos
gasto energético = gasto de energia
inclusões intraneuronais = estruturas que se formam dentro de neurônios
instabilidade postural = dificuldades de postura
levodopa = remédio que aumenta a quantidade de dopamina no corpo humano
mal de Parkinson = Doença de Parkinson
marcha = caminhada
marcha patológica = modo de caminhar típico de alguma doença
movimentos voluntários = movimentos que dependem da vontade da pessoa
neurônios dopaminérgicos = neurônios que produzem e liberam dopamina
neurotransmissor = substância que ajuda na transmissão de mensagens entre as células nervosas
núcleos da base = partes do cérebro que se comunicam e cuidam, por exemplo, da coordenação motora e da cognição
NB = partes do cérebro que se comunicam e cuidam, por exemplo, da coordenação motora e da cognição
parâmetros cinemáticos = padrões dos movimentos
parâmetros eletromiográficos = padrões elétricos do uso dos músculos
parâmetros espaço-temporais = padrões de espaço e tempo
parkinsonianos = pessoas que têm sintomas de DP
polissintomática = com vários sintomas
prejuízo funcional = prejuízo no funcionamento
quadro clínico = situação em que a pessoa se encontra; diagnóstico
rigidez = endurecimento
rigidez muscular = endurecimento dos músculos
sistema extrapiramidal = parte do cérebro que ajuda no controle dos movimentos do corpo
sistema nervoso central = estruturas localizadas dentro da cabeça e dentro coluna que possuem papel importante no controle do corpo
substância negra = estrutura do cérebro que produz a dopamina
sujeitos controle = pessoa sem a doença
tálamo = parte do cérebro que ajuda a entender e organizar movimentos mais difíceis do corpo
tratamento adjuvante = tratamento feito depois de a pessoa passar por cirurgia
tremores de repouso = tremedeira que acontece quando a pessoa está parada
velocidade autosselecionada = velocidade da caminhada
VAS = velocidade da caminhada
via nigro-estriada = caminho por onde a dopamina passa para realizar os movimentos do corpo

doença progressivo= esse aqui é o teste master
